результат: результате
маркса: маркса
распад: распад
счет: счет
опарина: опарина
начинать: начинает
лат: лат
выступить: выступил
доклад: докладом
годами: годами
генетик: генетику
роль: роль
планета: планете планеты планету
джон: джон
уолтер: уолтер
деление: деления
отводить: отводит отводили
предложить: предложил
соавтор: соавтор
мыслить: мысли
соединенных: соединенных
описанный: описанной описанные описан
получить: получил получили получить
относить: относят
сидень: сидни
водоросль: водорослей
близкий: близкие близок
диалектический: диалектический диалектического
ведать: ведали
некий: некоего
наблюдать: наблюдаем наблюдали
застать: застал
отличать: отличает отличала
забытый: забыта
небесный: небесными
страница: страницах
устроены: устроены
настоящий: настоящую настоящие настоящий
элементарный: элементарная
морской: морской морских
видеть: видели видит
повседневный: повседневный
частный: частном
блестящий: блестящие блестящая
май: мае
сложный: сложная сложную сложной сложными
отсутствие: отсутствия
делиться: делились
невозможный: невозможно
фермент: ферментов
экспериментальный: экспериментальная
данный: данная
сайт: сайта
специалист: специалист
ответ: ответы ответ
естествознание: естествознания
карьера: карьера
раствор: раствора
память: память
корреспондент: корреспондентом
абиогенезу: абиогенезу
преобразование: преобразования
век: веками веке века век
достижение: достижениями
мочь: могли
белковый: белковых белков белковой
мгу: мгу
нуклеиновых: нуклеиновых
монтмориллонит: монтмориллонит
иметься: имелось имеются имелись
якобы: якобы
сразу: сразу
любимый: любимых
подложке: подложке
главное: главное
смелый: смелые
доктор: доктора
абиогенез: абиогенез
всерьез: всерьез
дарвинизм: дарвинизма
реальный: реальные
код: кодом
узор: узоры
энгельс: энгельс
данные: данным
разработка: разработки
аррениус: аррениус
различный: различных различной
пресный: пресный
претендующей: претендующей
среди: среди
заря: заре
дарвин: дарвин
растение: растений
интерес: интересов
данность: данность
нагревание: нагревания
господство: господство
окруженный: окруженный
единомышленник: единомышленники
происхождение: происхождение происхождения
фокс: фокс
тридцатилетний: тридцатилетнем
функция: функции
трубка: трубками
дно: дне
современный: современные современной современного современным
личинка: личинки
жизненный: жизненная жизненной жизненных
геология: геологии
собственный: собственные
регуляция: регуляции регуляцией
биохимический: биохимических биохимическая биохимическую
появление: появления появление
метан: метана
древний: древней древнюю древнем
воспринять: воспринял
картина: картине картину
великий: великий
минеральный: минеральные
представитель: представители
аминокислота: аминокислот
наверняка: наверняка
гастрономический: гастрономических
впоследствии: впоследствии
след: следами следом
несмотря: несмотря
математический: математического
акцент: акцент
наличие: наличие наличии
обе: обе
энзимологии: энзимологии
шаг: шагом
заниматься: занимался занимается
череда: череда
водный: водно
впервые: впервые
организм: организмов
классик: классик
актуальный: актуальную
фосфорные: фосфорные
мембранной: мембранной
способность: способность способностью
сугубый: сугубо
описывать: описывает
атмосфера: атмосферой атмосфера атмосферу атмосферы
история: истории история
основа: основе
намек: намек
знание: знания знаниями
самокопирующие: самокопирующие
дарвином: дарвином
достаться: достанется
мгновенный: мгновенно
нечто: нечто
зерно: зерна
скорый: скорее
обратиться: обратился
создать: создали
настолько: настолько
лавуазье: лавуазье
неизмеримый: неизмеримо
распространенного: распространенного
родиться: родился
форум: форумах
бах: бахом баха бах
выйти: вышла вышло
англичанин: англичанин
прогрессивнее: прогрессивнее
ответить: ответила
согласный: согласно
совокупность: совокупность
субстрат: субстрат
расплавленный: расплавленный
фрагмент: фрагменты
насыщенный: насыщенной
игнорирование: игнорирования
тимирязева: тимирязева
действительность: действительности
оставаться: оставались оставалась
поглощение: поглощение
завариваривание: завариваривание
пацифист: пацифиста
абиогенезе: абиогенезе
последний: последних
звездному: звездному
особый: особый особое особая
русский: русского
поэтому: поэтому
работа: работах работы работа
продвинуть: продвинуть
жизнеспособный: жизнеспособную
учитывать: учитывают
михаил: михаил
исследование: исследований исследования исследованиях
левенгуком: левенгуком
оставить: оставил
помогать: помогала
оставлять: оставляет
располагая: располагая
геологический: геологических
содержащий: содержащие содержащий
сделать: сделали сделал
компонент: компоненты компонентами компонента
знакомый: знакомый
соединение: соединения соединений соединение
суметь: сумел
химия: химии
горлышко: горлышком горлышко горлышка
организатор: организатором
догма: догмой
юный: юной
сюда: сюда
фундамент: фундаментом
положение: положения
способный: способны способное способна
обладать: обладали
преимущество: преимущества
сформулированную: сформулированную
оказать: оказала оказал
непосредственный: непосредственное
пастера: пастера
дать: дать
путь: пути путь
сплошь: сплошь
технический: технической
организовать: организовал
питательный: питательной
ключевой: ключевые
предок: предками
научпоп: научпоп
отличие: отличие
соль: соли
матричный: матричном
суть: сути
содержание: содержание
ним: ним
холдейна: холдейна
хрупкий: хрупкой
предположить: предположил
клетка: клетки клеткам клетками клетку клеток
мясо: мясе
гравюра: гравюра
замкнутый: замкнутые
энгельса: энгельса
перенесение: перенесения
лекция: лекций лекции
включать: включает
сотрудник: сотрудники
провести: провели
сформулировать: сформулировать
подсказывать: подсказывал
индивидуальность: индивидуальностью
самый: самые самым самый самую самая
древность: древности
март: марта
аристократ: аристократа
влияние: влияние влияния
например: например
тело: телами тел
распространить: распространил
видеозапись: видеозапись
естественный: естественное естественном
неточность: неточностей
состав: состав
получаться: получается
этап: этап
книжка: книжки
структура: структура структуру структуры
экспрессия: экспрессии
биохимик: биохимик
целый: целом целые
разница: разницей
проверка: проверка
статья: статью
коацерватах: коацерватах
ссср: ссср
микроорганизм: микроорганизмов
зарождаться: зарождаются
рецепт: рецепты
пример: пример
портиться: портился
ход: ходу ход
член: член членом
отличный: отличную
подход: подход
меря: мере
креационизма: креационизма
стоять: стоит
житель: жителям жители
примечательный: примечательно примечательные
коммунист: коммуниста
жизнь: жизни жизнью
возможный: возможно возможным
используется: используется
синтетический: синтетическую
бактериальный: бактериальной
популяризация: популяризацией
смесь: смесь смеси
защита: защиты
насколько: насколько
время: времена
необычный: необычные
пришел: пришел
аммонийные: аммонийные
коллега: коллеги
деятельность: деятельности
свободный: свободном
фаза: фаз
материалистический: материалистическое
неизвестный: неизвестна
надежда: надежде
огромный: огромное огромную
иной: иными иные иным иное
война: войн
высказаться: высказался
расти: расти росли
вещество: вещество вещества веществ
руководить: руководил
ботанический: ботанического
одновременный: одновременное одновременно
океан: океане океана океаном
опубликовать: опубликовал
развитие: развитие развития
иметь: имеют имели имела
пар: пару паров
размышляя: размышляя
подчеркивали: подчеркивали
высокий: высокие
смысл: смысле
минерал: минералы минерала минералов
отдельный: отдельные
становиться: становились становятся
кислота: кислот
разнообразию: разнообразию
морозный: морозные
значимый: значимым
скрещиваться: скрещиваются
моделировать: моделировали
уровень: уровень
рассела: рассела
передавать: передавать
породить: породила
управлять: управляет
степень: степень
побывать: побывал
десяток: десятках
слово: словами словах слов
россия: россии
всякий: всякий
эволюционный: эволюционного эволюционную
получиться: получилась
неудивительный: неудивительно
номер: номер
молодой: молодой
искать: искали искать искало
сомнение: сомнений
учение: учения учение
перемещаться: перемещаются
активность: активность
ошибка: ошибок
находиться: находился
подтверждение: подтверждение
птица: птиц
упрямый: упрямый
спустя: спустя
причина: причин причина
широкий: широкое широко
загадочный: загадочным
рост: ростом
нагревать: нагревали
доступный: доступная
существование: существования
упомянутой: упомянутой
органикой: органикой
представлять: представляем представлял
выжить: выжить
свежий: свежих
остальное: остальных
четкой: четкой
сила: сила силы силе
упаковка: упаковке
таковой: таковы
земля: земле земля земли
создание: создание
некому: некому
пузырёк: пузырьки пузырьков
получение: получении
собраться: соберутся
жёлудь: желудей
знаменитый: знаменитый
эксперимент: эксперимент эксперименте экспериментов
разделение: разделения
система: система системы
спонтанный: спонтанного
пожаловать: пожалуй
религия: религии
физико: физико
телевидение: телевидении
александр: александр
прогрессивный: прогрессивным
ветер: ветру
вымирать: вымирают
вэхтерсхэузера: вэхтерсхэузера
тайный: тайны
одна: одна
химический: химические химических химической
философ: философы философ
водород: водород водорода
казаться: казалось
утка: утки
проблема: проблемы проблеме проблему проблемой
винить: винить
пора: порой
легкостью: легкостью
вместе: вместе
сторонник: сторонников
коацерваты: коацерваты
поглощённый: поглощено
иванович: иванович
муха: мух
классический: классические
велеть: вели
разуметься: разумеется
сложнее: сложнее
готовый: готового
живой: живые живое живого живых живой живым живыми живая
земной: земной
относительность: относительности
поток: поток
нехитрый: нехитрым
метаболизма: метаболизма
допускать: допускал допускают
смочь: смогли
становление: становление
внимание: внимания внимание
извне: извне
кристалл: кристаллы
итак: итак
оказываться: оказывались
часть: часть
отметиться: отметился
похожий: похожие
превращение: превращения превращение
стать: стала стали
слева: слева
общество: общества
водоем: водоем
другой: другую другому
предшествовавший: предшествовавший
пептидами: пептидами
мышь: мыши
органики: органики
энергия: энергии энергию
незнакомый: незнакомы
письмо: письме
джозефу: джозефу
внутри: внутри
британский: британского британский
маленький: маленький
природа: природы природой природе
больший: больший
луи: луи
ботаника: ботанику
прежде: прежде
представить: представить
эволюция: эволюции эволюция
второй: вторых вторая второго
плодовый: плодов
незримый: незримого незримой
использовать: использовал использовала
отделение: отделение
позволять: позволяет
материализм: материализм материализма
подвергаться: подвергался
просчет: просчет
юри: юри
абиогенеза: абиогенеза
себастиана: себастиана
начиная: начиная
нуждаться: нуждается
шанс: шансов
речь: речь
диссертация: диссертации
водоеме: водоеме
ряд: ряду ряд
усложняться: усложняться
экологический: экологическими
напрямую: напрямую
показать: показала
вода: воде воды воду
панспермии: панспермии
квантовый: квантовая
появляться: появлялись
помимо: помимо
явление: явлениям
называемая: называемая
отмечать: отмечает
нужный: нужные
жировой: жировой
установка: установка
ньютона: ньютона
постепенный: постепенно
центральный: центральной центральную
английский: английский
теплый: теплый
заодно: заодно
прогресс: прогресса
пастером: пастером
впереди: впереди
ученые: ученые
воздух: воздухе воздуха
наваристый: наваристый
происходить: происходят
сахар: сахара
потрясающий: потрясающему
такой: таком такую таких
френсисом: френсисом
никакой: никакие
неубедительный: неубедительной
откуда: откуда
анаксагора: анаксагора
институт: институт института
знать: знать знал
астрономия: астрономии
вселенной: вселенной
дарвина: дарвина
чарльз: чарльз
кислород: кислорода
мифология: мифологии
точнее: точнее
вписываться: вписывались
персональный: персональная
называть: называют
коллоидный: коллоидного
орёл: орлов
создано: создано
холдейн: холдейн
свой: свой
пола: поле
выглядеть: выглядели выглядит
далек: далек
начинаться: начиналась
содержать: содержала
уделить: уделим
подобный: подобно
доступ: доступ
факультет: факультета
говорить: говорят
послужить: послужила
отправной: отправной
существо: существа
удар: ударом
биология: биологии
теория: теории теория теорию
состояние: состоянии
безусловный: безусловно
питаться: питались
явный: явном
признак: признаков признаки
блистательный: блистательное
стеклянный: стеклянные стеклянного
нечему: нечему
начаться: началось начался
форма: форму
взгляд: взгляды взгляд
столетие: столетие
ген: генов
нагреваться: нагревалась
бельё: белья
масса: массу
внести: внесла
маловероятно: маловероятно
случайный: случайно
необитаемый: необитаемую
чрезвычайный: чрезвычайно
игнорировать: игнорировала
область: область
молекулярный: молекулярной
ставящие: ставящие
сам: самое
имеющий: имеющим
вклад: вклад вкладом
кончина: кончины
расхождение: расхождения
раковина: раковин
майонез: майонеза
болезнь: болезней
место: места место
металл: металлов
несомненный: несомненно
сформулировал: сформулировал
вспомнить: вспомним
простой: простыми простых простой простого
копировать: копировать
коацерватов: коацерватов
тепло: тепла
читать: читать
академия: академий
работать: работать работают работал
распадаться: распадались
фото: фото
идея: идеям идея идеи
способ: способ способом
относиться: относятся
гилберт: гилберт
смерть: смерти
начнем: начнем
бернал: бернал
чуждый: чуждыми
угличе: угличе
труд: труды труд трудах
издательство: издательстве
отличаться: отличаются
трансляция: трансляции
усвоено: усвоено
стекло: стекла
наступивший: наступивший
феномена: феномена
горячий: горячих
московский: московский
стиль: стиль
перейдет: перейдет
принятый: принято
реакция: реакций реакции
физиология: физиологии физиологию
самокопирующиеся: самокопирующиеся
школа: школы
лаборатория: лабораторий
наука: науку науки наука наукой науке
витализм: витализму
оседать: оседали
вбирать: вбирали
великобритания: великобритании
цитата: цитата
граница: границы
микроб: микробы микробов
опариным: опариным
монооксида: монооксида
ценный: ценное
открытие: открытия открытий открытие
механик: механика
сванте: сванте
возглавить: возглавил
нижний: нижнем
написать: написал
академик: академик академиком
возникнуть: возникли возникло возникла
завершение: завершения
содержаться: содержалась содержится
конкурировать: конкурируют
бум: бум
самовоспроизводству: самовоспроизводству
друг: друг друга
произойти: произойти
триада: триады
неизменный: неизменной
кафедра: кафедре
возраст: возрасте
называемых: называемых
липиды: липиды
тип: типами
править: правило
правильный: правильный
научный: научных научного научно научной научное научную научные
прошлое: прошлом прошлого
масштаб: масштабах
известный: известны известен известно
объект: объектам объекты
попытка: попытка
взяться: взялись взялось взялась
дело: дело деле
популярный: популярная популярной популярны
обратный: обратный
окружающий: окружающего окружающую
называемые: называемые
разреженной: разреженной
богатый: богатый
ультрафиолета: ультрафиолета
взаимосвязь: взаимосвязями
энзимология: энзимология
участник: участника
проводить: проводят
помощь: помощи помощью
введя: введя
курс: курс
источник: источники источника источниках
опыт: опыт опыты опытов
ацетиленовой: ацетиленовой
удачный: удачными
воссоздать: воссоздали
убеждаться: убеждаемся
поздно: поздно
поначалу: поначалу
прочий: прочие прочих прочими
университет: университете
растворенном: растворенном
недавний: недавние
начало: начале
правда: правда
биологический: биологической биологические
шифрование: шифрования
емко: емко
событие: событие
рабочий: рабочий
характер: характер
пятью: пятью
правдоподобный: правдоподобной
нашелся: нашелся
вулкан: вулканом
водяных: водяных
первый: первые первой первым первых первая первом первыми первое
происходящим: происходящим
мнение: мнения мнению
студент: студент
важный: важным важно важны
синтез: синтезом синтезе синтеза
конец: конце
порождать: порождает
некоторые: некоторые
кутить: кучу
разбирать: разбирал
обилие: обилие
выступление: выступлениях
служить: служила
считаться: считались считалось считается
основы: основы
восстановительный: восстановительный восстановительной
аммиак: аммиак аммиака
появиться: появилась
лишенной: лишенной
мюнстера: мюнстера
химик: химик химики
какой: каких каким каком какие
функционирование: функционировании
ученый: ученый
взять: взять
бульон: бульон бульона бульону
химизм: химизм
описать: описал
зарождение: зарождения зарождение зарождении
опаринскому: опаринскому
предположение: предположение
начать: начали начал
действие: действием действия действию
буква: буквы
существ: существ
правильность: правильности
клеточный: клеточной
самозарождение: самозарождение самозарождения самозарождению
очередь: очередь
видный: видным
рнк: рнк
стерильный: стерильную
полагать: полагал
поглощающей: поглощающей
пирита: пирита
помощник: помощники
иностранный: иностранных
либо: либо
одному: одному
пропускать: пропускали
намеченная: намеченная
увидеть: увидеть
процесс: процессов
обучаться: обучался
строение: строении
сказать: скажем сказали
неправдоподобный: неправдоподобно
пицца: пиццы
существовать: существовало
многие: многие многих многим многими
кумир: кумира
рубеж: рубежом
тот: той
столкнуться: столкнулась
рассуждение: рассуждения
днк: днк
состоять: состоит состояла состояли
объяснение: объяснение
день: дней
новый: нового новая новый новые новых
плохой: плохо
уклониться: уклониться
туманность: туманности
посложнее: посложнее
органический: органических органические
личность: личности
правило: правилами
опарин: опарин
благодаря: благодаря
взрыв: взрыве
миро: мире миру
воспринимать: воспринимать
тридцать: тридцати
дальний: далее
белка: белки белка белкам белками
указывать: указывают
маршалла: маршалла
центр: центре
рождаться: рождаются
поощрять: поощрял
саморегуляция: саморегуляция
генетический: генетическим генетическую
прибор: прибора
опубликован: опубликован
механизм: механизмов
необходимый: необходимые необходимыми
электрический: электрических электрические
прямой: прямыми
тремя: тремя
информация: информации информацию
заполнена: заполнена
выявление: выявление
среда: среды среду среде
заграничный: заграничных
своеобразный: своеобразный
считать: считал считать
никитина: никитина
попалить: попали
описание: описание
вечный: вечной вечная
времен: времен
большой: большом большой
разгадка: разгадка
духовный: духовного
минуть: минуло
заурядный: заурядным
изложены: изложены
окислительный: окислительный
крик: криком
прежнему: прежнему
программа: программа программы
термин: термин термина
индия: индии
холдейном: холдейном
миллер: миллер
колба: колбы колб
значение: значение
окислять: окислять
репликации: репликации
должный: должны должна
миллера: миллера
собрание: собрании
подняты: подняты
жила: жил
считывании: считывании
ускорять: ускорять
частность: частности
эйнштейна: эйнштейна
протеиноидные: протеиноидные
самопроизвольный: самопроизвольно самопроизвольного самопроизвольное
коацервату: коацервату
философия: философии
характерный: характерных
очевидный: очевидный
космография: космография
делать: делает
дерево: деревьев
человек: людей
молекула: молекулы молекул
располагать: располагал
уцелеть: уцелеть
микроскоп: микроскопов
гусь: гуси гусей
поскольку: поскольку
исследователь: исследователей
майка: майка
свет: света
гюнтера: гюнтера
сто: сто
исходный: исходно
вмешательство: вмешательством
небольшой: небольшая небольшой
глинистый: глинистые глинистых
мутируют: мутируют
физика: физика физик
носить: носила
горелка: горелке
движущий: движущей
фокса: фокса
гипотеза: гипотезой гипотеза гипотез гипотезы гипотезе гипотезу
вид: виде
шар: шар
идет: идет
высказать: высказал
сочетать: сочетать
обрасти: обросли
грязный: грязного
почетных: почетных
натуралист: натуралист
задать: задал
божественный: божественным
репликаторы: репликаторы
добивающим: добивающим
вытянутый: вытянутым вытянутую
конкуренция: конкуренцию
сущность: сущности
следующий: следующий
хранить: хранить
возникновение: возникновения возникновение
сероводород: сероводород
книга: книги книгах книга книгу книге
собранный: собранный
гипотетический: гипотетических гипотетически
поразительный: поразительно
мимоходом: мимоходом
считавшего: считавшего
награда: награды
точка: точкой
органику: органику
населять: населяет
карбидов: карбидов
процветать: процветают
положенный: положено
космос: космос космосе
окно: окнах
углерод: углеродом углерода
изгиб: изгибах
связана: связана
представление: представления представлений
литература: литературе
образовывать: образовывать
биофизик: биофизик
неживой: неживого неживой
едва: едва
образование: образование образования
бактерия: бактерии
вступать: вступали
командировка: командировок
населен: населен
велик: велики
гукеру: гукеру
проблемный: проблемное
образный: образным
квест: квест
воспринимая: воспринимая
достаточный: достаточно
брошюра: брошюра
идеальный: идеальной
мир: мир
материальный: материальным
отламывания: отламывания
который: которую которыми которому
привычный: привычны
десмонд: десмонд
первичный: первичный первичном первичного первичному первичная первичной
намеренный: намеренно
множество: множество
биохимия: биохимии биохимию
переведена: переведена
условие: условиях условия
свойство: свойств свойства
разряд: разрядов разряды
микросферы: микросферы
название: названия
удивительный: удивительно
отражать: отражает
отбор: отборе
революционный: революционные
вопрос: вопросом вопросы вопрос вопроса
распространение: распространение распространении
зачаток: зачатков
отнести: отнести
возникшем: возникшем
формировались: формировались
преобладать: преобладал
направленный: направленный
нашить: нашей
образоваться: образуются образовалось
быстрый: быстро быстрее
окончить: окончил
число: числе
взаимодействие: взаимодействию взаимодействие
биосфера: биосферы
