интересный: интересна
кунказавру: кунказавру
статья: статьи
представитель: представители
фауна: фауны
спинной: спинных
куэнка: куэнка
крестцовых: крестцовых
вроде: вроде
жить: жили
европейский: европейских европейского европейской
африканский: африканского
сильный: сильно
место: месте
сложный: сложного
измельчавших: измельчавших
позволять: позволяет
планета: планете
тазовый: тазовый
который: которое которым
фото: фото
дорсомедиально: дорсомедиально
включая: включая
годы: годы
успевшими: успевшими
состоять: состоит
культурный: культурных
латинский: латинского
боковой: боковой
метр: метров
шея: шеи
распространены: распространены
порода: пород
африка: африке африка
название: название
суставные: суставные
возникнув: возникнув
конвергентное: конвергентное
кунказавры: кунказавры
остров: островов
меловом: меловом
гигантский: гигантского
кихота: кихота
предок: предки
прояснить: прояснить
группа: групп группа
трасса: трассы
вероятный: вероятно
миллион: миллионы
гость: гостями
антарктиду: антарктиду
форма: форма
частить: части
дорсальный: дорсальный
условие: условиям
мост: мостами
найденный: найденный
длинный: длинных
минимум: минимум
пояс: пояс
королева: королеве
чей: чьи
таксонов: таксонов
открытие: открытие
сочлененными: сочлененными
достигать: достигать достигали
найденные: найденные
вместе: вместе
географических: географических
уникальный: уникальных
нехарактерно: нехарактерно
габарит: габаритов
связанный: связанных
необычный: необычный
поверхность: поверхности
указание: указанием
динозавр: динозавры динозавров
континент: континентам
зауроподы: зауроподы
вперед: вперед
встречаться: встречались
оставаться: остаются
отсылка: отсылок отсылка
жизнь: жизни
успешный: успешных успешно
конец: конца конце
крупнейший: крупнейших
плохой: плохо
возможность: возможность
распространиться: распространились
размер: размеру размеров
южный: южной южная
роман: романов романа
состав: состава
новый: нового новый
распространяться: распространялись
позвонок: позвонки позвонков
рыцарский: рыцарских
принцип: принципе
лирайнозавровые: лирайнозавровые
одни: одни
остеодермы: остеодермы
передний: передней передняя передние
образоваться: образуется
наклонены: наклонены
обнаружены: обнаружены
анна: анна
новиковская: новиковская
разнообразный: разнообразной
филогению: филогению
героин: героине
карликовый: карликовых
апрель: апреле
столб: столб
видовой: видовое
первый: первых
кладой: кладой
опистоцеликаудин: опистоцеликаудин
одному: одному
женский: женская
куэнкой: куэнкой
патаготитана: патаготитана
обнаруженный: обнаруженный
глава: главу
кихот: кихот
существование: существование
сухопутный: сухопутными
зауропод: зауропод
местонахождение: местонахождении местонахождения местонахождение
частичный: частичных
сауре: сауре
сходство: сходство
полный: полных
шар: шару
позвоночный: позвоночный
неопределенного: неопределенного
описанный: описан
ребер: ребер
костя: кости
расположение: расположения
сальтазавровые: сальтазавровые
америка: америках америке америки америка
раскопки: раскопок раскопки
сравнительный: сравнительно
предположительно: предположительно
прибыль: прибыли
малоизученный: малоизученными
художник: художнику
источник: источник
хвост: хвоста
развиться: развились развилось
шкура: шкуры
красный: красным
выдвинуть: выдвинуть
фрагментарные: фрагментарные
возможный: возможно
титанозаврам: титанозаврам
провинция: провинции
местный: местных местным
семейство: семейства
муниципалитет: муниципалитет
скудный: скудных
рисунок: рисунок
сближать: сближает
голотип: голотип
элемент: элементов элементом элементы
лирайнозаврин: лирайнозаврин
южноамериканский: южноамериканского южноамериканских
мадьярозавра: мадьярозавра
характерный: характерный
половина: половина
фуэнтес: фуэнтес
адаптировавшимися: адаптировавшимися
предположить: предположить
период: периоде
европа: европе европы европу европа
строительство: строительства
город: города
образный: образный
палеонтологический: палеонтологический палеонтологической
вид: вида вид видов
испанский: испанском
грудной: грудных
библиотека: библиотеки
лирайнозаврины: лирайнозаврины
кунказавра: кунказавра
время: времена
титанозавров: титанозавров
длина: длину длины
костный: костные
закрашены: закрашены
уточнить: уточнить
целый: целый
крючкообразный: крючкообразный
пинтикинестре: пинтикинестре
юго: юго
сальтазавров: сальтазавров
земной: земному
ранний: раннем раннего
названный: названный
андалузского: андалузского
разный: разных
куэнки: куэнки
существовать: существовали
давний: давним
процветать: процветали
слово: слова
часть: часть
внутри: внутри
нынешний: нынешней
стать: стали
гальский: гальский
островной: островной
защита: защиты
азия: азии
редкий: редкую
гигант: гиганты
эволюционный: эволюционных
предоставить: предоставило
обнаружено: обнаружено
окаменелость: окаменелостей
антонио: антонио
творческий: творческой
одинаковый: одинаковой
хвостовой: хвостовых
судя: судя
материал: материал
сайт: сайта
поздний: позднем позднего
подсемейство: подсемейств подсемейства
некрупный: некрупные
комплекс: комплекса
адаптироваться: адаптироваться
реконструкция: реконструкция
связь: связи
известный: известно
эолозаврами: эолозаврами
учитывая: учитывая
западный: западной
позволить: позволил
обнаружить: обнаружили
свести: свели
действие: действия
экологический: экологических
найден: найден
древний: древнего
связана: связана
сервантеса: сервантеса
отличаться: отличается
недавний: недавними
вес: вес
ненамного: ненамного
остаток: остатки
особенность: особенностей
пластина: пластинах
выживание: выживания
презентация: презентации
куэнке: куэнке
мести: мела
испания: испания
неполный: неполный
конечность: конечностей
амадис: амадис
островные: островные
обнаружен: обнаружен
превосходить: превосходили
толстый: толще
уважение: уважения
ум: ума
предполагать: предполагает
ресурс: ресурсах
присутствовать: присутствовали
возникнуть: возник
дань: дань
человек: человеком
сообщество: сообщества
предположение: предположение
хищник: хищников
северный: северной
ранее: ранее
титанозавры: титанозавры
например: например
независимый: независимо
представленный: представленной
нескольких: нескольких
графику: графику
близкородственный: близкородственных
сравнение: сравнении
уэко: уэко
самый: самых самыми
считая: считая
опистоцеликаудины: опистоцеликаудины
мел: мелу
карлик: карлики карликами
связаны: связаны
килограммовый: килограммов
летопись: летописи
некоторые: некоторые
пластинка: пластинки пластинок
греческий: греческий
обсуждаемой: обсуждаемой
располагаться: располагалась
ради: ради
родственный: родственные родственной родственных
тонна: тонны
средний: средних
задний: задней
выступающий: выступающий
отросток: отросток
скорый: скорее
карта: карте карта
скелет: скелетов скелета
процветавших: процветавших
дожили: дожили
результат: результат
факторов: факторов
дон: дон
разойтись: разошлись
отсутствие: отсутствие
большинство: большинство
неудивительный: неудивительно
ящер: ящер
получить: получил
процесс: процессе
извлечение: извлечения
территория: территории
сальтазавры: сальтазавры
слон: слона
ход: ходе
относиться: относятся
рост: роста
изоляция: изоляции
маленькая: маленьких
такой: таких
эолозавров: эолозавров
