межвидовых: межвидовых
приведена: приведена
статистический: статистические
иметь: имеет имеют
сайт: сайта
журнал: журнале
встреча: встреч
показывать: показывает
модель: моделями модели моделей
совместный: совместного
содержать: содержали
выявить: выявили
вредитель: вредители вредителей вредителем
массово: массово
обратиться: обратился
годов: годов
влиять: влияют
значительный: значительно
выяснить: выяснить
получать: получают
земля: земли
экосистема: экосистемах экосистем экосистемы
направо: направо
пресный: пресные
жук: жуки
феномен: феномен
ген: генов
полный: полную полные полного
следовать: следует
одна: одна
происходить: происходит
сложность: сложность сложности
изученных: изученных
неопределенность: неопределенность
пять: пяти
паук: пауков
главный: главный
сушь: суши
вынужденный: вынужденных
винера: винера
заселять: заселять
глобальный: глобальных глобального глобальное
планета: планеты
паукообразный: паукообразных
научный: научные
выразить: выразить
мочь: могли
подтвердить: подтвердил
падать: падает
вымереть: вымерли
элемент: элементы
область: областях область области областей
розенберг: розенберг
счет: счет
иерархический: иерархические
таки: таки
некогда: некогда
данный: данном
отражать: отражают
чувствительность: чувствительности
выявление: выявление
возрасти: возросло
разнообразия: разнообразия
подтверждать: подтверждают
отличаться: отличаются
зачастую: зачастую
история: истории
проблема: проблем проблемами проблемы
биологический: биологического
америка: америка америки америку америке
показано: показано
степень: степени
сша: сша
яркий: яркий
организация: организации
образный: образная
обсуждаемой: обсуждаемой
обходиться: обходиться
дает: дает
распространенных: распространенных
прогнозирование: прогнозированием
германий: германии
михаил: михаил
максимальный: максимальную максимальна
класс: классах классов
благодаря: благодаря
судьба: судьба
традиционный: традиционного
насколько: насколько
систематический: систематических систематическая
климат: климата
связаны: связаны
переход: переходу
либо: либо
растение: растений
площадка: площадок
вымерший: вымерший
какой: какие
сообщество: сообществах сообщества сообществе сообществ сообществами
разрешение: разрешению разрешения
момент: момент
измениться: изменилось
обе: обе
следующий: следующим
дальний: дальние далее
миграция: миграции миграциям
конкретный: конкретным конкретном
отмеченные: отмеченные
меняться: меняется
разряд: разряд
подчеркивая: подчеркивая
определенных: определенных
редкий: редких реже редкие
азия: азии
взаимодополняющих: взаимодополняющих
рассматривать: рассматривать
сомнение: сомнений
имеющий: имеющих имеющие
сценарий: сценария сценарии сценарий сценариев сценарием сценарию
представлять: представляет
местообитание: местообитание
опубликованных: опубликованных
годы: годы
успех: успеха
сравнить: сравнить сравнили
двухвостки: двухвостки
корреляция: корреляция
участвовать: участвуют
продуктивный: продуктивный
уменьшаться: уменьшается
медиана: медиана
указать: указал
такой: таким таком таких
привести: привести
популяционными: популяционными
картинка: картинку
скрыточелюстных: скрыточелюстных
согласный: согласно
противоречить: противоречит
странствующего: странствующего
широкий: широко широк
график: график
исчезновение: исчезновения исчезновению исчезновение
равный: равна равными
говорить: говорят
привлекательный: привлекательной
симпсона: симпсона
общий: общее общая общий общие общей общего
событие: событий
сэмплирования: сэмплирования
юго: юго
реализоваться: реализуются
заменять: заменяют
обсуждаться: обсуждалось
существ: существ
биосфера: биосферы
приходиться: приходится
высокий: высокую
тренд: тренд
красный: красный
новый: новая новых новую новый
восточный: восточной
огромный: огромного
родственник: родственников
источник: источник
больший: большую большего
достигнуть: достигли
метаанализа: метаанализа
неродственных: неродственных
ценность: ценности
процесс: процесс
получиться: получится
включены: включены
карта: карта
пенницы: пенницы
особый: особое
рассчитать: рассчитать рассчитали
организм: организмов
различие: различия
добиться: добились
неоднородность: неоднородностью
среди: среди
поэтому: поэтому
насущный: насущная
реальный: реальную реальных
животное: животных
проведение: проведения
постигнуть: постигла
пространство: пространства
основа: основе
изученные: изученные
интенсификацией: интенсификацией
фото: фото
вызывать: вызывает
единственный: единственным
некорректный: некорректным
среда: сред
записывается: записывается
кривой: кривая
изменяться: изменяется
неполнота: неполноты
ведущая: ведущей ведущую
бытовой: бытовое
размер: размерами
возможный: возможно
уничтожающий: уничтожающие
ученых: ученых
оценка: оценкам оценка оценки
вероятность: вероятность
эволюция: эволюции
чреватый: чреватый
цветковый: цветков
природоохранных: природоохранных
графиках: графиках
начало: начале
потеря: потеря потере потерей
исходный: исходно
изменение: изменением изменениям изменения изменений изменение изменениях изменениями
прибегать: прибегают
некоторый: некоторое
наблюдаемые: наблюдаемые
клещи: клещей
роль: роли роль
сельский: сельского
южный: южной
разделить: разделили
входить: входят
ускоренный: ускоренной
причина: причиной причины
определять: определяет
рассмотреть: рассмотрим рассмотрели
длительность: длительность
характерный: характерно
уровень: уровнях уровня уровне
человек: людям человека
характеризовать: характеризует
подход: подходов подход
другой: другими другого
заметный: заметно
наблюдение: наблюдение наблюдений наблюдения
наука: науки
слово: слов словами
распределение: распределение
храниться: хранятся
показать: показали
международный: международный
являться: является
лобового: лобового
услуга: услуг
выявлять: выявляет
динамика: динамику
противоположный: противоположным
друг: друг другу друга
природа: природе
пресноводный: пресноводные
короткоусые: короткоусые
энтомофильных: энтомофильных
трех: трех
убывать: убывает
трендов: трендов
экстраполировать: экстраполировать
относиться: относятся
день: дня
поездка: поездок
выражать: выражает
структура: структуре структуры
ежегодное: ежегодное
привел: привел
многозначный: многозначное
сюда: сюда
подобный: подобных подобную подобные подобная
отводить: отводит
четких: четких
ярка: яркой
нимфалид: нимфалид
полезный: полезно полезные
центральный: центральной
озерах: озерах
род: рода
биология: биологии
прежде: прежде
дополнить: дополнили
перечисленных: перечисленных
пресс: пресс
относить: относят
мониторинг: мониторинг
оси: оси
показана: показана
анализ: анализа анализом анализ
байесовские: байесовские
низкий: низкую низкой низкое
поведение: поведение
составить: составит
сумеречный: сумеречным
массовый: массовым
сокращающуюся: сокращающуюся
регион: регионы регионов
биолог: биологов
показатель: показателя показатели показатель
планирование: планированием
обильный: обильных
относительный: относительного относительно
лиловый: лиловые
точность: точность
описывать: описывает
исключить: исключить
неожиданный: неожиданным
очевидный: очевидным
стекло: стекла стекло
опылитель: опылителей
используется: используется
основный: основных основные
медианное: медианное
прямокрылый: прямокрылые
уменьшение: уменьшение уменьшением
соотношение: соотношение
объясняться: объясняться
сдвинуться: сдвинутся
справа: справа
результат: результатам результат
подробнее: подробнее
прошлое: прошлом
быстрый: быстро быстрее быстрой быстрому быстрая
миллион: миллион
задача: задача задачу
сохраняться: сохраняются сохраняется
коллемболы: коллемболы
разбившихся: разбившихся
недостаток: недостаток недостатком
картина: картину
отметить: отметили
исчезнуть: исчезнут исчез
расти: растут
проведенный: проведенный
охват: охват
проверить: проверили
статья: статье статьи статья статей
снижение: снижение снижением
начиная: начиная
поставиться: поставили
полностью: полностью
мелкий: мелкие
март: марта
сократиться: сократилась
связано: связано
антропогенный: антропогенный
становиться: становится становятся
число: число числа числом числе
рассмотренные: рассмотренные
суммарный: суммарной суммарными суммарного
самый: самыми самых самая самые самым
меря: мере
краевой: краевых
значимый: значимое значимого
трендами: трендами
кукурузный: кукурузная
база: базой базе
варьировать: варьирует варьировала
сочетание: сочетание
треть: третей
локация: локаций
первый: первым
любопытный: любопытно
скалистый: скалистых
специальный: специальные
определенная: определенная
мера: мер
ученые: ученые
бадьева: бадьева
чешуекрылые: чешуекрылые
опровергать: опровергает
локальный: локальное
великобритания: великобритании
стать: станет
соответствовать: соответствуют
предполагать: предполагаем
разрыв: разрыв
использовать: использовать использовали
определение: определения
наземный: наземных
ход: ходе
трактоваться: трактуется
водитель: водителям
кормовой: кормовой
сезонный: сезонным
формула: формулы
монарх: монарх монарха
лобовое: лобовое
множество: множество множества
шеннона: шеннона
пропорциональный: пропорциональное пропорционально пропорциональному
ежегодно: ежегодно
получить: получили
определяться: определяется
особа: особой
популярный: популярное популярной
экосистемных: экосистемных
представленный: представленных представлены
питательный: питательной
европа: европа европу
терять: теряют
опубликованной: опубликованной
константин: константин
группа: группы групп группа группах
типичный: типичная
приводить: приводит
вымирание: вымирания
бабочка: бабочек бабочки
биоразнообразие: биоразнообразие
метаанализ: метаанализ
выборка: выборки
начавшие: начавшие
эрозия: эрозией
обилие: обилию обилие обилий обилия обилием
площадь: площади
сравнивать: сравнивать
австралия: австралии
вода: воды
ночной: ночным
численность: численность численности численностью численностей
связь: связей связь
различный: различного различные различных
используются: используются
рисунок: рисунок
минимальный: минимальную
сохраниться: сохранилась
поскольку: поскольку
место: места
неравномерный: неравномерного
ряд: ряд
отследить: отследить
исследование: исследований исследования исследованиях
длительный: длительных
описанный: описанных описанный описанные описано
система: систем
видовой: видовое видовой видовых видового
позволить: позволили
биоразнообразия: биоразнообразия
например: например
убыток: убытками
наблюдаемый: наблюдаемый
примерно: примерно
центр: центре
предварительный: предварительно
век: веке века
экологический: экологических экологическими
скорость: скорость скоростью
обширный: обширная
неизменный: неизменных
река: реках
малочисленный: малочисленных малочисленным малочисленные
слева: слева
объяснять: объясняют
последний: последний последнее
автор: авторы авторами авторов
распространение: распространением
считая: считая
меньший: меньшей
применять: применяют
тренды: тренды
мнение: мнение
внимание: внимание
форма: форм форма
экология: экологии
очистить: очистили
вероятный: вероятно
странствующий: странствующий
рис: рис
который: которое которую которому
совершать: совершает
живой: живых
инвазивных: инвазивных
желтый: желтый
обязательный: обязательно
реальность: реальность
многие: многие многих многом
отношение: отношения
величина: величина величины величине
выравненность: выравненность
иной: иной иными
иметься: имеется имелись
вычислить: вычислили
отчетливый: отчетливый
правдоподобный: правдоподобным
исторический: исторического
данные: данные данных
биосообществе: биосообществе
объема: объема
соответствие: соответствии
институт: института
данаида: данаида
проанализировать: проанализировали
фиалка: фиалки
учитывающих: учитывающих
состав: состава составе
исчезать: исчезают
использованный: использовано использованных использованы
встречаться: встречались
ранее: ранее
простой: простых простые
публикация: публикации публикациях публикаций публикацию публикация
отсутствие: отсутствии
оригинальный: оригинальной
семейство: семейства
включить: включили
микроорганизм: микроорганизмов
затрагивать: затрагивает
созданной: созданной
удалив: удалив
рост: рост
насекомоопыляемых: насекомоопыляемых
количество: количество количества
сокращаться: сокращаются
исчезающий: исчезающие
автомобиль: автомобиля
обитатель: обитателями
каждый: каждого каждом каждой
обсуждаемая: обсуждаемая
учитывать: учитывает
окраска: окраске
метрика: метрик метрики метриках
оказаться: оказалось оказался
изучавшая: изучавшая
сокращение: сокращения сокращение сокращению сокращением сокращении
загрязнение: загрязнением
превышать: превышает
объемов: объемов
описание: описания
доля: доли
готовый: готовые готовом
таксономические: таксономические
вывод: вывод выводам выводу
называемый: называемый
целый: целом
синий: синий синие
местообитания: местообитания
оставаться: оставаться
опыление: опылении
сложный: сложное
примитивный: примитивных
двумерные: двумерные
снижать: снижает
важность: важность
гора: гор
профессор: профессор
природный: природных
особь: особей
важный: важных
близкий: близки
подчеркивают: подчеркивают
саранча: саранча саранчи
случай: случае случаях
отмывать: отмывать
служить: служат
знать: знать
сближение: сближении
рассчитанный: рассчитанные рассчитана
постоянный: постоянным
известный: известны
сильный: сильнее
обратить: обратили
помогая: помогая
зависеть: зависит зависят зависели
увеличиваться: увеличивается
северцова: северцова
отдельный: отдельных отдельно
устойчивость: устойчивость
видимый: видимому
вина: вине
россия: россии
сочетаться: сочетаются
географические: географические
страдать: страдают
ранний: ранних
предсказанное: предсказанное
моль: моли
полученные: полученные
почва: почв
значение: значение значений значения значениями
масштаб: масштабах
образ: образом
необходимый: необходимо
таксономическому: таксономическому
частность: частности
тренда: тренда
приемы: приемы
универсальный: универсальных
понятие: понятие
понять: понять
отличать: отличает
отбросить: отбросить
землепользование: землепользования землепользование
распространенное: распространенное
коллектив: коллектив
проведенных: проведенных
тон: тона
главное: главным
прокомментировать: прокомментировал
многочисленный: многочисленными многочисленным многочисленных многочисленного
десяток: десятков
рамка: рамках
построить: построить
сложнее: сложнее
работа: работ работа работы
править: правило
подмножества: подмножества
категория: категорий категория категории
водоемах: водоемах
голубь: голубя голубь
подходить: подходит
некоторые: некоторых некоторые
вид: вид виды видов вида виде
сотня: сотни
позвоночный: позвоночных
индекс: индекс индексе индексы индекса
разнородный: разнородная
насекомое: насекомое насекомых насекомые насекомым
нехватка: нехватки
распространено: распространено
устоявшимся: устоявшимся
орёл: орлов
уникальный: уникальных
недавний: недавней недавними
прийти: пришли пришла
описывающие: описывающие
претендовать: претендует
тревога: тревоги
протяженным: протяженным
гораздо: гораздо
одному: одному
дальнейший: дальнейших
останки: останков
оказывать: оказывают
нуль: нулю
разнообразие: разнообразие
описывающих: описывающих
прочесть: прочесть
приложение: приложении
эволюционный: эволюционного
единица: единицу
увеличение: увеличение увеличении
цвет: цвет цветами
тенденция: тенденции тенденция тенденцию
эффект: эффектов
демонстрировать: демонстрирует
вопрос: вопросам
ранговое: ранговое
координаты: координатах
северный: северная северную северной
самостоятельный: самостоятельно
найти: нашли
дополнительный: дополнительно дополнительные
стабильный: стабильно
рана: ран
разный: разных разного разными
жизнь: жизни
богатство: богатство богатства
обозначение: обозначения
протуры: протуры
действительность: действительности
тля: тля
пример: пример примера примеры
позволять: позволяет
хищный: хищные
слюнявый: слюнявой
хозяйство: хозяйства
самоопыление: самоопылением самоопылению
крупный: крупной
авторегрессии: авторегрессии
континент: континентах
тесный: тесно
средний: средних средней среднее среднем средними
зеландии: зеландии
второй: второму
снижаться: снижается снижаются снижалось
невозможный: невозможно
предел: пределах
популяция: популяций популяции популяциями
тип: типов
гонгальский: гонгальский
характеристика: характеристика характеристик характеристики
представление: представление представлениям
большинство: большинстве
падение: падение
небольшой: небольшое
антропогенными: антропогенными
