хондроитиназа: хондроитиназа
моно: моно
митохондрии: митохондрии
прикрепленные: прикрепленные
апикальный: апикальные апикальный
постоянный: постоянно
создает: создает
путем: путем
расположение: расположение
ток: ток
бэрри: бэрри
филогения: филогения
половой: половое
рис: рис
видимость: видимости
дать: дали
центр: центре центр центра
краситель: красителем краситель
экстремальными: экстремальными
показывать: показывает показывают
сайт: сайте
изображены: изображены
следовать: следовало следует
предстоять: предстояло предстоит
колониальный: колониальные колониальных
особенность: особенности
цитоплазматической: цитоплазматической
отсылать: отсылает
проба: проб
исследованный: исследованных
бактериальный: бактериальные бактериальной бактериальным бактериальных бактериальное
изображение: изображение изображении
среди: среди
журнал: журнале
гора: горах
полный: полную
массовый: массовая
самый: самых самая
исследователь: исследователя
медиана: медиана
филоподии: филоподии
проникнуть: проникнуть проникли
ядерный: ядерными
полисахаридов: полисахаридов
хоанофлагеллятам: хоанофлагеллятам
состоять: состояли
рисунок: рисунок рисунках
вольвокс: вольвокс
берег: берега
мочь: могли
знак: знаку
альфа: альфа
лабораторный: лабораторных
отчетливая: отчетливая
часть: часть
сохранить: сохранить
микроворсинок: микроворсинок
большинство: большинство
максимальный: максимальной максимального
тяж: тяжи тяжами
люмен: люмен
антитело: антителами
интерференционно: интерференционно
дальний: далее
удалось: удалось
больший: большую большей
домик: домиках
дерево: дерево дерева
состоящий: состоящий
специфичному: специфичному
лаборатория: лаборатории
ядро: ядра
иметь: имеют имеет
узнаваемый: узнаваемый
лидбитера: лидбитера
помимо: помимо
кодирующих: кодирующих
симбиотическая: симбиотическая
коэволюции: коэволюции
эукариот: эукариот
микрометр: микрометров микрометра
испания: испании
положение: положение положения
гамма: гамма
используемый: используемого
черта: черты
поселиться: поселились
вид: вид виды видов виде видом вида
мерка: меркам
корзинка: корзинки
метаболит: метаболит
орёл: орлов
основанный: основана
изомер: изомеров
филотипы: филотипы
модель: модель
зрение: зрения
норвегии: норвегии
древо: древо
обе: обе
форма: форм форму форме форма формы
скопление: скопления
флуоресцентно: флуоресцентно
влияние: влиянию
систематический: систематических
выдающийся: выдающегося
филотипов: филотипов
весь: всей
верхний: верхнем
похожий: похожи
образование: образование
расположенный: расположено
сеть: сеть
выяснить: выяснить
слать: шли
голуба: голубой
показать: показало показал показала
воротничковые: воротничковые
море: моря
схема: схеме
хемоорганогетеротрофы: хемоорганогетеротрофы
протеобактерии: протеобактерии
ближайший: ближайших ближайшие ближайшими
микровиллей: микровиллей
настоящий: настоящие
отличаться: отличаются
цвет: цвет цветами
перенос: переноса
любой: любые
друг: друга
оси: оси
родовой: родовое
карта: карта
занимающая: занимающая
ученые: ученые
великобритания: великобритании
сьерра: сьерра
толщина: толщине
крупный: крупные крупный крупная
прокариот: прокариот
скелет: скелета скелет
эксперимент: эксперименты
свет: свет
жгутик: жгутик жгутиков жгутика жгутики
срез: срез срезов
организм: организмы организмами организм организмов
интерес: интерес
интересный: интересное
способный: способны
трехмерной: трехмерной
отрезка: отрезка отрезок
симбиотическую: симбиотическую
грибной: грибным
филогенетическое: филогенетическое
сложный: сложных сложной
шрифт: шрифтом
составлять: составляет
стрелок: стрелками
длина: длина длиной длину
средний: среднем среднее
делиться: делиться
отношение: отношением
белковый: белков
содержать: содержат
слово: слова
вакуоль: вакуоль
среда: среде среды
преобладать: преобладают
фотосинтезу: фотосинтезу
мембрана: мембране мембран
рибосомальной: рибосомальной
альбумин: альбумина
уровень: уровнем
инкубировать: инкубировали
полученный: полученный
целиком: целиком
описать: описали
тело: тела
клеточный: клеточного клеточную клеточной клеточные
наложение: наложение
межклеточный: межклеточные
калифорний: калифорнии калифорния
некоторые: некоторые некоторых
служить: служит
хрестоматийный: хрестоматийный
набор: набор
который: которое которыми
доказать: доказали
секвенировали: секвенировали
протерозойский: протерозойский
белая: белым белые
зонд: зондом зондов зонд
реконструкция: реконструкция реконструкции
микроскоп: микроскопом
синий: синий
внеклеточный: внеклеточный
родич: родичей
окраска: окраска
метагеном: метагеном
стадия: стадиях
облик: облик
порядок: порядка порядок
правдоподобие: правдоподобия
тека: тека
белка: белку белки
встраиваться: встраиваться
хёхст: хёхст
жгутиконосца: жгутиконосца
флуоресцентным: флуоресцентным
желтый: желтый
протиста: протиста
ориентацию: ориентацию
кислород: кислороду
четырем: четырем
озеро: озера озере озеру
фаллоидином: фаллоидином
полость: полости
содержание: содержанием
представляющих: представляющих
множество: множество множества
расшифрован: расшифрован
полярность: полярность
вроде: вроде
оптический: оптическое оптических
пассивный: пассивным
пурпурный: пурпурный пурпурных пурпурные
объединённый: объединены
выясниться: выяснилось
торчащих: торчащих
показано: показано
ножка: ножкой
иной: иным
заднежгутиковые: заднежгутиковые
хоанофлагелляты: хоанофлагелляты
загадка: загадкой
число: числе число числа
дальнейший: дальнейшие
симбиотические: симбиотические
источник: источник
достигать: достигать достигают
специфичных: специфичных
прикреплённый: прикреплены
обозначена: обозначена
отдельный: отдельные
примитивный: примитивных
точка: точки
видовой: видовой
ориентирована: ориентирована
неизбирательно: неизбирательно
покрытый: покрытыми
построить: построили
обильный: обильные
фирменный: фирменный
хоанофлагеллят: хоанофлагеллят
уникальный: уникальные
означать: означало
структура: структуры
процесс: процесс процессы
пример: примеры пример примере
заметный: заметны
ррнк: ррнк
ветвящихся: ветвящихся
обнаружены: обнаружены
нуклеоиды: нуклеоиды
теках: теках
тубулину: тубулину
исключительный: исключительно
работа: работы
соединять: соединяют
ультратонких: ультратонких
замена: замен
стандартный: стандартную
симбиоз: симбиоз
публикация: публикации
мелкий: мелких мелкие
врезка: врезке
геном: геномы
наличие: наличие
бокаловидный: бокаловидный
вместо: вместо
образец: образца
тонкий: тонкий тонких
обернуты: обернуты
либо: либо
серный: серных серные
обнаружен: обнаружен
обозначенный: обозначенный
роднить: роднит
группа: группа групп группы группу
одними: одними
округлый: округлую
водоема: водоема
счастье: счастью
совокупность: совокупностей
представитель: представители
сопроводительный: сопроводительных
резкий: резко
фотосинтезом: фотосинтезом
фиолетовый: фиолетовый
цикл: цикла
насколько: насколько
животное: животным животных животные
входить: входят
подтвердить: подтвердила
метр: метров
специфичный: специфичный
поскольку: поскольку
консервативный: консервативных
играть: играют
живет: живет
простейший: простейшими
размытый: размытое
близкий: близок близкого близки
пробраться: пробраться
кружочек: кружочки
родственник: родственники родственниками
окрашены: окрашены
боковыми: боковыми
какой: каких каким
конканавалином: конканавалином
приносить: приносит
эволюционный: эволюционные
культивируемых: культивируемых
обеспечивать: обеспечивают
указаны: указаны
неродственных: неродственных
зеленый: зеленый
оранжевый: оранжевый
течь: теку
жизнь: жизни
периметр: периметру
матриксу: матриксу
культура: культуре
обращен: обращен
разрез: разрезе
образующих: образующих
щелочной: щелочном щелочного
сферическую: сферическую
показана: показана
счет: счет
внутри: внутри
избирательный: избирательно избирательным
найден: найден
взвешенный: взвешенные
кружок: кружком
переходный: переходное
сапротрофным: сапротрофным
примерно: примерно
красный: красный
дифференциальная: дифференциальная
образ: образом образ
протисты: протисты
одноклеточный: одноклеточных одноклеточные одноклеточными одноклеточным
матрикс: матрикс
нужный: нужна нужны
серия: серии
способность: способности
значение: значение
небольшой: небольшим
несомненный: несомненно
адаптаций: адаптаций
сша: сша
органелл: органелл
движение: движения
отрезок: отрезков
микроорганизм: микроорганизм микроорганизмов
многоклеточный: многоклеточных многоклеточными многоклеточные
питание: питания питание
вызывать: вызывает
размер: размер размеров размером размеры размера размеру
линия: линией
окрашивать: окрашивает
причем: причем
смочь: смогли
культивировать: культивировать
прикрепление: прикрепления
симбионты: симбионты
исходный: исходные
обнаружить: обнаружили
морфология: морфология морфологию
внутрь: внутрь
новый: новой новый новая
приходиться: приходится
поэтому: поэтому
сходство: сходства
окруженный: окруженный
помечены: помечены
поддержка: поддержка
ткань: ткани
характер: характере
конструкция: конструкция
последний: последний
организация: организации
базальное: базальное
тельце: тельце
микроскопия: микроскопии микроскопия
область: области
ход: ходе
целлюлозы: целлюлозы
встречаться: встречается встречаются встречался
ворсинка: ворсинкам ворсинок
микробиомы: микробиомы
распознающим: распознающим
поверхность: поверхностями
данные: данным данные
принадлежать: принадлежат
детрит: детрита
потребляются: потребляются
наружу: наружу
зеленых: зеленых
охарактеризовать: охарактеризовала
гиперсоленого: гиперсоленого
апостериорный: апостериорные
биологический: биологические
мкм: мкм
оседать: оседают
вести: ведут
относящийся: относящийся
малочисленный: малочисленным
центральный: центральной
уменьшенной: уменьшенной
графика: графика
относиться: относятся
соединяющих: соединяющих
статья: статьи статья
система: системы систему система
главное: главным
одну: одну
штамм: штамм
латинский: латинского
микросферы: микросферы
распространенности: распространенности
делить: делят
пэм: пэм
основание: основания основании
флуоресцентная: флуоресцентная
остается: остается
единственный: единственной единственный единственным
разнообразие: разнообразие
живущий: живущих
михаил: михаил
нижний: нижний
обозначены: обозначены
флуоресцентный: флуоресцентный
фрагмент: фрагменты
пролить: пролить
показан: показан
являться: являются
обогащённый: обогащены
запускать: запускает
гетеротрофов: гетеротрофов
честь: честь
подавляющий: подавляющее
амеб: амеб
связаны: связаны
ложный: ложными
нитевидный: нитевидные нитевидных
целый: целый
ожидать: ожидать
второй: вторым
каждый: каждой
экватор: экватора
интенсивность: интенсивностью
неукорененное: неукорененное
мутуалистическим: мутуалистическим
живой: живого живы
тесный: тесно
показаны: показаны
жгутиконосцы: жгутиконосцы
бутстрап: бутстрап
рнк: рнк
варьировать: варьируют варьирует
соединённый: соединены
звездочки: звездочки
молекула: молекулами
миллиард: миллиарда
клетка: клетки клеток клетка клеткам
фагоцитоза: фагоцитоза
размножение: размножения размножение
сечение: сечение
высокий: высоким
успешный: успешно
возникнуть: возникли
воронко: воронка
существ: существ
современный: современных
ген: геном генов
соединенных: соединенных
микроворсинки: микроворсинки
необычный: необычную
фотосинтетическим: фотосинтетическим
прийтись: пришлось
окрасить: окрасил
разный: разной разных
меченый: мечеными
земля: земле
придает: придает
гриб: грибам грибов
природный: природную
описанный: описанный описанное
комплекс: комплекс
скобка: скобками
предел: пределы
возрастать: возрастало
галофильного: галофильного
сравнительный: сравнительно
одиночный: одиночный
вероятность: вероятности
сферические: сферические
выходить: выходит
хоанофлагеллятами: хоанофлагеллятами
участие: участием
тип: типами тип типа типов
внутренний: внутренняя внутренние
образованный: образовано образована
семейство: семейства
стенка: стенка стенку стенки
микротрубочек: микротрубочек
применение: применением
род: род
традиционный: традиционно
считать: считают считать
картина: картину картины
попасть: попасть
устроенный: устроенных
растительный: растительным растительных
просвечивающей: просвечивающей
ассоциированные: ассоциированные
например: например
специализированные: специализированные
населять: населяют
понять: понять
типичный: типичная
жгутиконосцев: жгутиконосцев
автор: авторы
перемещение: перемещением
сывороточного: сывороточного
эволюция: эволюции
заметить: заметили
извне: извне
население: население
помощь: помощью
мышьяк: мышьяка
выделенный: выделен
заполнена: заполнена
жирный: жирным жирной
количество: количество
микросферами: микросферами
вода: воды водах
своеобразный: своеобразная своеобразную своеобразных
отражать: отражает
хозяин: хозяев
класс: классу класса классам
взаимодействовать: взаимодействуют
считаться: считаются
протистов: протистов
внеклеточным: внеклеточным
невада: невада
протеобактерий: протеобактерий
слой: слоем
имеющий: имеющие имеющих
видный: видна видно видны
вырост: выросты
жить: живут жить
воротничок: воротничком воротничка воротничок воротничков
общий: общий общего общее
основа: основе
последовательность: последовательностях последовательностей последовательности
помечен: помечен
увидеть: увидеть
комменсальным: комменсальным
разветвленный: разветвленный
жгутиковые: жгутиковые
панель: панелей
очевидный: очевидно
палочковидных: палочковидных
помочь: помогут
связь: связи
активный: активным активном
рибосомальных: рибосомальных
мостик: мостиками мостики мостиков
соседний: соседние
матрикса: матрикса
находка: находки
смотреть: смотрят
невелики: невелики
инфузория: инфузорий
пищеварительный: пищеварительная
ценный: ценная
изучение: изучения изучение
предположение: предположение
помешать: помешало
представленный: представлена
рассол: рассоле
цитоплазматические: цитоплазматические
внеклеточному: внеклеточному
просвет: просвета
искусственный: искусственные
условие: условиях условиями
водоросль: водорослей
специализация: специализация
цитоплазматическими: цитоплазматическими
диаметр: диаметр
оказаться: оказалось
суффикс: суффикса
голубой: голубые голубым
аминокислота: аминокислотами
застрять: застряли
обсуждаемой: обсуждаемой
яйцевидную: яйцевидную
начальный: начальная
хоаноциты: хоаноциты
образовать: образует образуют
конец: конца конце
роль: роль
трехмерная: трехмерная
известный: известен
переносящим: переносящим
провести: провели
природа: природе
соленом: соленом
название: название
орган: органы
прародитель: прародителем
монослой: монослой
отбор: отбора
обозначенные: обозначенные
жизненный: жизненных жизненного
эон: эон
макроэволюции: макроэволюции
дело: дело
родственный: родственна родственного родственные
внеклеточного: внеклеточного
соответствовать: соответствует
впервые: впервые
симбиотической: симбиотической
разнообразный: разнообразных разнообразного
находиться: находятся
удобство: удобства
построено: построено
масштабный: масштабного масштабных масштабный
воротничковых: воротничковых
пятно: пятно
единичный: единичных
бактерия: бактерии бактериями бактерий бактерия
пойманы: пойманы
сравнимый: сравнимо
окрашивание: окрашивании окрашивание
бокаловидных: бокаловидных
днк: днк
вышеперечисленных: вышеперечисленных
эпитет: эпитет
симбионтов: симбионтов
участвовать: участвуют
материал: материалах
фаготрофным: фаготрофным
обитать: обитают
гибридизация: гибридизация
частить: части
аноксигенному: аноксигенному
частица: частицы
прозрачность: прозрачностью
добавление: добавлением
контрастный: контрастная
байесовские: байесовские
бычий: бычьего
специфический: специфические
взаимодействие: взаимодействий взаимодействия
первый: первым первыми
основный: основные основным основная
матриксом: матриксом
вопрос: вопросов
появление: появление
голый: голые
ряд: ряд
медианное: медианное
построение: построения
чрезвычайный: чрезвычайно
особый: особый
греческий: греческого
предок: предок
использовать: использовали
называть: называли
элемент: элементы
строить: строят
серийный: серийных
латексными: латексными
обитание: обитания
субстрат: субстрату
место: месту местах
окрашен: окрашен
сам: самое
засветиться: засветились
колония: колония колонии колонию колониях колоний
начать: начало
характерный: характерна характерно
специфичен: специфичен
пища: пища
электронный: электронной
развиваться: развиваются
весьма: весьма
вдоль: вдоль
белый: белый
культивирование: культивирования
продолжать: продолжают
микроб: микробов
важный: важную
различный: различными различных различным
трех: трех
ветвь: ветвью
губка: губок
устроены: устроены
высота: высоте высота
полученных: полученных
