носитель: носителями
нижний: нижняя нижней
череп: черепу черепа череп черепов черепом
разнообразный: разнообразным
четкая: четкая
детенышей: детенышей
исчезнуть: исчезли
морфология: морфологии
вид: видов виды
среди: среди
добыча: добычей
слово: слову
млекопитающий: млекопитающих млекопитающими млекопитающие млекопитающим млекопитающего
очередной: очередной
развитие: развитие
аргентина: аргентины
великобритания: великобритании
обнаружить: обнаружили
идет: идет
оказываться: оказывались
покров: покров
вопрос: вопрос
родство: родства
потомок: потомком потомки потомков
челюстными: челюстными
выполнять: выполнять
главный: главный
вероятный: вероятно
массивный: массивные
разделить: разделить
представитель: представителей
относительный: относительный
размер: размер размером
начать: начали
либо: либо
палеонтолог: палеонтологи палеонтологам
животное: животных животным животные
отсутствовать: отсутствовал
вызванный: вызванный
показательный: показательный
молоточек: молоточком
известный: известный
случать: случай
молоко: молоком
сухопутный: сухопутных
роль: роли роль
филогенетическое: филогенетическое
исследователь: исследователей исследователи
вторичный: вторичный
уменьшить: уменьшил
строение: строение строении
челюстного: челюстного
вступить: вступила
ответить: ответить
вариант: вариантов
возникнуть: возник
кость: костями кость костью
распределение: распределение
помогать: помогало
прогрессивный: прогрессивных
случай: случае
создать: создали
средний: среднем
дополнительный: дополнительный
зубной: зубной зубного зубные зубная
ученые: ученые
предлагать: предлагали
отстоящей: отстоящей
наследник: наследник
нагрузка: нагрузку нагрузкой
выясниться: выяснилось
хаотичный: хаотичную
больший: больших
поздний: позднем поздних
остальное: остальному остальные
позволять: позволяет
бразилодона: бразилодона
близость: близости
трехмерное: трехмерное
пример: пример
изменение: изменения
поэтому: поэтому
миниатюризация: миниатюризация
целый: целый
встречающиеся: встречающиеся
увидеть: увидеть
свидетельствовать: свидетельствовала
палеозоя: палеозоя
картинка: картинку
цинодонты: цинодонты
предок: предками предком предков
задача: задача
такой: таких такого таким
единственный: единственный
анатомия: анатомию анатомии
цинодонтов: цинодонтов
проведенного: проведенного
отстоящие: отстоящие
крупный: крупнее
мерило: мерилом
зарождающийся: зарождающийся
крыса: крысы
слева: слева
рисунок: рисунок
организм: организмов
сустав: сустава сустав суставами суставы суставом
вскармливание: вскармливание
отражать: отражает
экологический: экологической
ниша: ниши
непростой: непростая
крепиться: крепится крепилась
сочленовной: сочленовной
дифиодонтного: дифиодонтного
квадратно: квадратно
неравномерный: неравномерно
насекомое: насекомыми
одно: одно
похожий: похожих похожий
челюстные: челюстные
образ: образом
модель: модели
отношение: отношению
мыщелок: мыщелок
юрских: юрских
напротив: напротив
исследование: исследование исследования
пора: порой
томографию: томографию
скорый: скорее
некоторые: некоторых
день: дня
затруднять: затрудняет
способ: способов
циногнат: циногнат
источник: источник
провести: провести
чешуйчатый: чешуйчатой чешуйчатый
сходство: сходство
часть: часть
отстоять: отстоит
появление: появлению
рептилия: рептилиями
примитивный: примитивным примитивный
ход: ходе
морганукодона: морганукодона
оценить: оценить
палеонтологический: палеонтологических
встречаться: встречались
подсмотренное: подсмотренное
происходить: происходила
заметный: заметно
немаммальных: немаммальных
однозначный: однозначно
челюсть: челюсть челюсти челюстью челюстей
повысить: повысить
сочленовная: сочленовная
линия: линии
заставить: заставило заставила
различение: различение
присущий: присущ
сочленовную: сочленовную
используя: используя
триасового: триасового
сестринский: сестринского
достигать: достигал
напоминать: напоминали напоминало
граница: границу
позднетриасовым: позднетриасовым
бразилия: бразилии
сочленовный: сочленовный
перестройка: перестройке перестройки
новый: новое нового новой
ученых: ученых
эволюционный: эволюционных эволюционном эволюционной эволюционно
который: которым
план: плане
новиковская: новиковская
прочность: прочность
лишившись: лишившись
мешать: мешало
триасе: триасе
отличаться: отличаются отличались
самый: самых самый
повлечь: повлекли повлечь
мочь: могла
справа: справа
древо: древе
четырьмя: четырьмя
гребень: гребнем
консервативный: консервативны
конец: конце
мышца: мышц
благодаря: благодаря
наших: наших
реорганизация: реорганизация
летопись: летописи
возможный: возможным
латеральный: латеральным
уменьшиться: уменьшиться
итог: итоге
трехмерные: трехмерные
позднетриасовые: позднетриасовые
современный: современных
первый: первых первым
ряд: ряд
век: веков
неоднократный: неоднократно
волк: волка
анна: анна
квадратный: квадратной
надугловую: надугловую
группа: группах группой группы группа
переход: переход
синапсид: синапсид
ранний: ранних ранний
постепенный: постепенно
раннеюрского: раннеюрского
хадрокодиума: хадрокодиума
положение: положение
поначалу: поначалу
беспозвоночный: беспозвоночными
челюстной: челюстной
близкий: ближе близки
уникальный: уникальные
височный: височной
позднетриасового: позднетриасового
степень: степени
укус: укуса
период: периода
цинодонтам: цинодонтам
жизнь: жизни
риограндии: риограндии
конкуренция: конкуренция
большинство: большинство
речь: речь
выделять: выделяют
ископаемый: ископаемой
угловой: угловую
основа: основе
разделение: разделение
функция: функции
проводить: проводить
микрокомпьютерную: микрокомпьютерную
ведущая: ведущей
считаться: считается считалось
международный: международной международная
верхний: верхний
эволюция: эволюции эволюция
многие: многие многих
наравне: наравне
число: числе
статья: статьи
жевательный: жевательных
костя: кости
спереди: спереди
образовав: образовав
зубно: зубно
продвинутость: продвинутость
сохраняться: сохраняются
существовать: существовало
объяснение: объяснение
сыграть: сыграла
показать: показали показало
простой: простых
особый: особо особый
раннетриасового: раннетриасового
тринаксодона: тринаксодона
одним: одним
совпадающая: совпадающая
укрепление: укрепление
продвинутый: продвинутые продвинутый продвинутых
абсолютный: абсолютный
снизу: снизу
разделены: разделены
намного: намного
настоящий: настоящий
начавшаяся: начавшаяся
питание: питание питания
черта: черты
шерстный: шерстный
контакт: контакт контакта
таксона: таксона
филогенетической: филогенетической
отросток: отросток отростка
моделирование: моделирование
задуматься: задуматься
исключение: исключением
класс: класса
развиться: развился
оказаться: оказался
реконструировав: реконструировав
обязательный: обязательное
относить: относили
время: временем
двойной: двойной
занять: заняла
различный: различной
филогенетическом: филогенетическом
любой: любого
данный: данном
ближайший: ближайшие
родственник: родственники
изучить: изучить
позвоночный: позвоночных
стать: стала стало
боковой: боковой
другой: другими
сильный: сильно сильнее сильного
аппарат: аппарата
исконный: исконной
предполагаться: предполагалось предполагается
эффективный: эффективного
справляться: справлялся
америка: америки
считать: считать
цинодонт: цинодонт
особенность: особенности
нашего: нашего
смещая: смещая
дорасти: доросла
расположенный: расположена
выемка: выемка
становиться: становились
грань: грань
доказательство: доказательств
суставной: суставной
смена: сменой
проанализировать: проанализировала
масштаб: масштабах
признак: признаков признаку признака признак
результат: результаты
дело: дело деле
последний: последние
человек: человека
раннетриасовые: раннетриасовые
например: например
произойти: произошли
южный: южной
мозаика: мозаику
род: рода
обсуждаемой: обсуждаемой
