поняты: поняты
обсуждаемой: обсуждаемой
удовлетворение: удовлетворения
показаны: показаны
тёмный: темно
транспозон: транспозон
рис: рис
причем: причем
антидепрессант: антидепрессанты
регулировать: регулируют регулирует
случай: случае случаях
пролиферация: пролиферация
рождение: рождения
выделяющими: выделяющими
каждый: каждого
связано: связано
серотонилирования: серотонилирования
изменять: изменяет
открытый: открытым открытого
содержать: содержит содержали
стимулирующим: стимулирующим
дорсальное: дорсальное
малиновый: малиновые
конструкция: конструкций конструкцию конструкции
ввести: ввели ввести
нейромедиатором: нейромедиатором
глиобластома: глиобластома
дело: дело
красный: красный красная
час: часа
самый: самых самый
смочь: смогли
опубликовать: опубликовал
приводя: приводя
понятный: понятно
рост: рост роста росту
онкогенов: онкогенов
тканевый: тканевая
клозапина: клозапина
мутантный: мутантный
выключенными: выключенными
сенсорный: сенсорную
химерным: химерным
схожий: схожие
выживаемость: выживаемость
средний: среднем
располагаться: располагается располагалась
высокий: выше
эксперимент: экспериментов эксперимента эксперимент
обозначены: обозначены
ранее: ранее
закодированный: закодированный
смесь: смесь
видный: видно
время: временем
функция: функции функций функцией
состояние: состояние состояний
притуплять: притупляет
помещать: помещали
большой: большой
повышенный: повышенной
автор: авторы
серотонилированный: серотонилированный
снижать: снижает
включая: включая
голубой: голубые
факторами: факторами
предложить: предложили
эпендимомой: эпендимомой
раствор: раствора
образоваться: образовались
модулировать: модулирует
шов: шва
положительный: положительных
антитело: антитела
ключевой: ключевых
штрихкод: штрихкод
кишечник: кишечника кишечнике
лаборатория: лаборатория
вопрос: вопрос
распространенный: распространенный
обозначен: обозначен
замена: заменой
серотонилируется: серотонилируется
транскрипционный: транскрипционный
днк: днк
новообразование: новообразований
электропорации: электропорации
транспозоны: транспозоны
продукт: продукт
нервный: нервных
дофамин: дофамин
транскрипционного: транскрипционного
рецептор: рецепторы рецептор рецептора рецепторов
определенные: определенные
доступность: доступность
изучен: изучен
окружать: окружают
напрямую: напрямую
метода: метод методами
характеристика: характеристик
меченных: меченных
точный: точно
приостановлена: приостановлена
эпендимома: эпендимома
исследовательский: исследовательского
дополнительный: дополнительно дополнительных дополнительной
яркий: ярко
метилирование: метилирование
поддержание: поддержания
лизин: лизин
связанный: связанного связан
транскрипции: транскрипции
служить: служит
зеленый: зеленый
розовый: розовым розовые
иммуноблот: иммуноблот
среди: среди
молекула: молекула молекулами молекулой
модифицированный: модифицированный
полушарие: полушарии полушарие полушария
неспроста: неспроста
аминокислотный: аминокислотным
репарация: репарации
пятно: пятна
ямка: ямки
физиологических: физиологических
репликации: репликации
мускаринового: мускаринового
ситуация: ситуация
совместный: совместно
колледж: колледжа
оказаться: оказалось оказались
бенжамина: бенжамина
введение: введением введении
низкий: низкое
ограничивая: ограничивая
вместе: вместе
множество: множество
образовываться: образовывались
мониторинг: мониторинга
встраиваться: встраиваться
транскрипционные: транскрипционные
синапсов: синапсов
направленный: направленно
притупить: притупить
подводя: подводя
обеспечивать: обеспечивают
серотонилированию: серотонилированию
получившийся: получившийся
кодирующих: кодирующих
новорожденных: новорожденных
вирус: вирусы
присутствовать: присутствует
эпигенетическими: эпигенетическими
дальнейший: дальнейший
скрининг: скрининг
воздействие: воздействия
способствовать: способствует способствуют способствовали
окрашивание: окрашивание
локусов: локусов
гидрокситриптамин: гидрокситриптамин
деление: деления делением делению
цинковый: цинковыми
стивена: стивена
настроение: настроения
моноаминовые: моноаминовые
выбрасывать: выбрасывали
серый: серым
серотонилировать: серотонилировать
экспрессируются: экспрессируются
метильными: метильными
достигаться: достигается
состоящей: состоящей
вырабатывающих: вырабатывающих
роль: роли роль
нейрон: нейроны нейронов нейронах нейронами
обучение: обучения
активироваться: активируются активировались
делящихся: делящихся
пептида: пептида
иметь: имеет
выживаемости: выживаемости
присоединяться: присоединяться присоединяется
группа: группы группами
изменение: изменениями
кодировать: кодируют кодировали кодирует
исследование: исследование
эпендимомах: эпендимомах
гистона: гистона
ограничивать: ограничивает
торможение: торможение торможении
показано: показано
лечение: лечения
уровень: уровень
глиом: глиом
участок: участки участках
известный: известен
подверженный: подвержены
соответствующий: соответствующие
снижение: снижению
называть: называют
ацетилирование: ацетилирование
образование: образованием образования
отсутствие: отсутствие отсутствием
вызывать: вызывает
проанализировав: проанализировав
одним: одним
вводить: вводили
речь: речь
кровь: крови
синаптических: синаптических
гиперактивность: гиперактивность
либо: либо
количество: количество количеством
мозг: мозга мозге мозг
изучены: изучены
различный: различными различные различных
внеклеточным: внеклеточным
способный: способны способен
сдерживании: сдерживании
желудочек: желудочки
влияя: влияя
чувство: чувства
отличаться: отличается
больший: большей большими большим
вступать: вступать
секвенированием: секвенированием
синий: синий
повреждение: повреждений
выражено: выражено
увеличение: увеличению увеличение увеличении
определенный: определенный
белок: белком
исключено: исключено
привести: привело
глиомы: глиомы
замешан: замешан
контролировать: контролируют
маркёр: маркер
промотором: промотором
иммунопреципитации: иммунопреципитации
факт: факт
ген: генов гена геном гены ген
день: дни
полость: полость
гистоны: гистоны
помогать: помогает
стабильный: стабильной
вовлечены: вовлечены
отдельность: отдельности
серотонин: серотонин
убиквитинирование: убиквитинирование
дикий: дикого
закрывать: закрывает
химерный: химерный
явление: явлений
описанный: описан
модифицирован: модифицирован
уверенный: уверены
здоровый: здоровые
контроль: контроль
хроматина: хроматина
проблема: проблемам
частность: частности
серотонилированного: серотонилированного
аланин: аланин
внеклеточный: внеклеточный
реакция: реакции реакциях
серотонилирование: серотонилирование
совершенный: совершенно
сделать: сделали
эпендимомы: эпендимомы
плохой: плохо хуже
иуда: иуды
проводиться: проводились
глии: глии
эмбрион: эмбрионы
дорсального: дорсального
зеленым: зеленым
химерной: химерной
молекулярный: молекулярно молекулярных
кружочек: кружочки
экспрессия: экспрессии экспрессию экспрессией экспрессия
завязано: завязано
обозначена: обозначена
сконструированными: сконструированными
серотонилированному: серотонилированному
модифицирует: модифицирует
нейромедиатор: нейромедиатор
фактор: фактор
обнаружить: обнаружили обнаружить
сконструированные: сконструированные
эмбриональный: эмбрионального
участвующих: участвующих
клетка: клетки клетками клеток клетках
серотонилированием: серотонилированием
годов: годов
сравнить: сравнили
погрузиться: погрузились
смотреть: смотрели
снизить: снизить
число: числе
гистонами: гистонами
тремя: тремя
определенным: определенным
кора: коре коры
сверху: сверху
встречаться: встречается встречались
контекст: контексте
участвовать: участвует участвуют
эпендимом: эпендимом
регуляция: регуляции регуляция
препарат: препаратом препараты
кандидат: кандидатов
нейропептид: нейропептид
прежде: прежде
секретируемого: секретируемого
активный: активных активно активная активным активного активному
белковый: белковому белков
начать: начало
нуклеосома: нуклеосома
вывод: вывод
отдельный: отдельным
влиять: влияет влиять влияло
ускорять: ускоряет
импульс: импульсов
очередь: очередь
конкретно: конкретно
аденоассоциированные: аденоассоциированные
получать: получали
нокаут: нокаут
описывающая: описывающая
иммунитет: иммунитета
конец: конце
орган: органах
контролем: контролем
сокращать: сокращает
развитие: развитие развития
брюшной: брюшную
линия: линия
исключительный: исключительно
метильных: метильных
начинаться: начиналась
экспрессировали: экспрессировали
поэтому: поэтому
этап: этапе
несет: несет
святой: святого
окружающий: окружающие окружающей
мышей: мышей
сравнение: сравнению
факторов: факторов
наблюдение: наблюдения наблюдение
различие: различия
хроматиновыми: хроматиновыми
находиться: находится находятся находилась
нуклеосомы: нуклеосомы
регулирующим: регулирующим
ацетилированным: ацетилированным
трансформированных: трансформированных
кодирующие: кодирующие
фаддея: фаддея
мутация: мутациями мутацией
штрихкодом: штрихкодом
итог: итог
гистон: гистон
который: которое котором
приводить: приводит приводило приводили
генетический: генетических
контрольный: контрольных
последующий: последующим
значение: значение
прошлое: прошлом
упаковка: упаковку упаковке
журнал: журнал
детский: детского
гипотеза: гипотезу гипотеза
доступный: доступного доступными
нуклеотид: нуклеотидов
попадая: попадая
опухолевый: опухолевые опухолевых
зеленые: зеленые
сигнал: сигнала
статья: статьи
путь: пути
помечены: помечены
прогрессирование: прогрессирование
терапия: терапии
первый: первая первую
буквальный: буквально
делать: делает делают
фактора: фактора
умерщвлять: умерщвляли
хроматин: хроматин
изучать: изучают изучали
феномен: феномен
называться: называется
играть: играет
транскрипционных: транскрипционных
сша: сша
мак: мака
взаимодействие: взаимодействием
узнать: узнали
черным: черным
регулирование: регулировании
рисунок: рисунок
связаться: связаться
процесс: процессы процессов процессе
заниматься: занимается
мышиный: мышиных мышиной
китайский: китайские
мышь: мыши мышам мышах
черепной: черепной
факторы: факторы
микрофотографиях: микрофотографиях
наоборот: наоборот
поддерживающих: поддерживающих
эпендимомами: эпендимомами
источник: источник
связаны: связаны
бейлора: бейлора
стать: стало стать
показывать: показывает
состоять: состояла
репрессия: репрессии
показать: показали показало
объяснить: объяснить
другой: другим другом другими
инициировать: инициировать
грачева: грачева
подход: подход
вырастать: вырастала
изучение: изучением
палец: пальцами
сокращение: сокращения
синтезировать: синтезировать
гистонов: гистонов
посчитать: посчитали
ребёнок: детей
когнитивный: когнитивным
коагуляция: коагуляции
информация: информацию
стимулировать: стимулирует
модель: моделей модели
часть: частью
поведенческий: поведенческих
химиотерапии: химиотерапии
увеличивать: увеличивает увеличивать увеличивают
активировать: активирует активировать активировали
применить: применили
подобный: подобный
спустя: спустя
матка: матки
американский: американские
выключать: выключает
пациент: пациента
фактором: фактором
использовать: использовали используют
экспрессировать: экспрессировать
схема: схема схемы
исследователь: исследователи исследователей
плазмид: плазмид
глутамина: глутамина
белка: белкам белки белок белками
синаптическая: синаптическая
темп: темпы темпов
такой: таких таким
нейромедиаторы: нейромедиаторы
последовательность: последовательности
аналогичный: аналогичным
следующий: следующем
обратный: обратный
например: например
комплекс: комплексу комплекс
человек: человека
наблюдаться: наблюдается
серотонилирован: серотонилирован
сеть: сетях
друг: друг
физиологические: физиологические
денена: денена
данный: данном
становиться: становится
основный: основные основными основных основным
педиатрическая: педиатрическая
медицинский: медицинского
двойной: двойная двойной
способ: способов способ
происходить: происходят
моторики: моторики
обладать: обладала
слева: слева
сильный: сильно
устойчивый: устойчивая
цвет: цветом цвет
захват: захват
засветиться: засветился
изучено: изучено
распределение: распределение
восстановить: восстановить
физиологического: физиологического
повышается: повышается
активность: активность активности активностью
выделять: выделяют выделяли
клеточный: клеточным
механизм: механизм механизмы механизмов
катехоламины: катехоламины
своевременный: своевременной
активация: активации активация
объеме: объеме
выброшенного: выброшенного
лизину: лизину
некоторые: некоторых
выживать: выживали
работа: работа работу
поиск: поиске
составлять: составляет
разработать: разработала
транскрибируются: транскрибируются
экспрессировался: экспрессировался
экспрессируя: экспрессируя
головной: головного
мутантного: мутантного
злокачественный: злокачественных
синить: синим
снижаться: снижается снижалась
неактивного: неактивного
госпиталь: госпиталя
агрессивный: агрессивная агрессивных
нейронный: нейронные нейронная нейронной нейронную
запускающих: запускающих
идея: идее
помечен: помечен
опухоль: опухоли опухолей опухоль опухолях
ткань: ткани
промоторов: промоторов
окрашенные: окрашенные
животное: животных
многие: многие
достаточный: достаточно
трансглутаминаза: трансглутаминаза
тромбоцитами: тромбоцитами
разный: разному
понимание: понимания
психиатрический: психиатрических
пятилетний: пятилетняя
важный: важно важную важной
селективно: селективно
уменьшаться: уменьшалась
интересный: интересно интересных интересное
гистону: гистону
зависеть: зависит
изображены: изображены
встречаемость: встречаемости
считаться: считается
какой: каким какие
образ: образом
нейропептида: нейропептида
фермент: фермент
остаток: остатком
меченый: меченым
интеграция: интеграции
серотонина: серотонина
отличие: отличие
транскрипцию: транскрипцию
екатерина: екатерина
задний: задней задних
являться: является
связываться: связывается связываются связываться
нейробиологии: нейробиологии
изучить: изучили изучить
место: местах
заболевание: заболеваний
схематичный: схематично
обозначать: обозначают
вариант: вариантов вариант
ряд: ряд
подтвердить: подтвердить
штрихкода: штрихкода
модулирующие: модулирующие
глутамину: глутамину
оксид: оксида оксидом оксид
увеличиваться: увеличивался увеличивалась увеличивается
выжить: выжило
скринингом: скринингом
желтым: желтым
аминогруппой: аминогруппой
лизином: лизином
тип: типа типы
микрофотография: микрофотография
блокировать: блокировать
вид: виды
ядро: ядра ядре ядро ядер
баркодированием: баркодированием
триметилированного: триметилированного
регулирующие: регулирующие
помощь: помощью
четырех: четырех
поглощать: поглощают поглощать
выстилающих: выстилающих
оставаться: оставался
модификация: модификации модификация
метка: метка метку
неактивное: неактивное
эпендимоме: эпендимоме
