противоречивый: противоречивых
ветвь: ветвями
действовать: действовать
изменение: изменения изменениям
любой: любой
случай: случае
доселе: доселе
узнавание: узнавание
мюллера: мюллера
понять: понять
довершение: довершение
часть: часть
явный: явно явные
появление: появление появлениям
реагировать: реагирует
заболевание: заболевания
резкий: резко
течение: течение
полезный: полезными полезным
крепкий: крепко
приобретенный: приобретенный
мутагенез: мутагенез
накопление: накопления
событие: события
однородный: однородном
неузнаваемый: неузнаваемыми
время: временем
конкурировать: конкурируют
способствовать: способствует
хозяин: хозяев
организм: организмов организм
связаны: связаны
мутирования: мутирования
появляться: появляется
позвоночный: позвоночные
ген: гены генах
экспериментальный: экспериментально
слева: слева
полезность: полезность
адаптивным: адаптивным
фиксация: фиксации
нейтрализующие: нейтрализующие
заражать: заражают
походить: походить
достигать: достигает достигать
предсказуемость: предсказуемость
ослабевать: ослабевает ослабевать
называемых: называемых
точность: точности
фон: фоне
неуклонный: неуклонно
одним: одним
конкурент: конкурентов
пропадать: пропадает
называться: называются
переход: переход переходов
дальнейший: дальнейшую
условный: условное
размер: размера
конец: конце
частота: частот частоты частота частоте частоту
производящий: производящие
поверхностный: поверхностных поверхностные
геном: генома
показано: показано
выздоровевший: выздоровевший
факторы: факторы
среди: среди
рост: роста росту рост
кратный: кратное
ряд: ряд
увидеть: увидели
связать: связать
колебаться: колебаться
источник: источник
иммунный: иммунной иммунных иммунном
друг: друг друга
смотреть: смотрит
красный: красные
разнообразный: разнообразной
сформированному: сформированному
репликации: репликации
успешный: успешных успешный успешным
случайный: случайным
уменьшать: уменьшает
отбор: отбор отбора отбором
ошибка: ошибок
ускользании: ускользании
конечный: конечном
бактерия: бактерия
уничтожить: уничтожить
обладать: обладают обладает
предсказуемости: предсказуемости
рис: рис
клетка: клеток клетками клетки
ожидаемую: ожидаемую
продолжаться: продолжается
тот: той
пересекаться: пересекаются
ускользающий: ускользающий
донор: донора
повторный: повторном
задача: задачу
ранее: ранее
распределение: распределение
велеть: вели
встреча: встреч встречи
родиться: родился
происходить: происходит происходят
эпитопах: эпитопах
чужак: чужака чужаки
одинаковы: одинаковы
распространение: распространения
рассмотрение: рассмотрении
гемагглютинине: гемагглютинине
адаптивных: адаптивных
краткосрочный: краткосрочного
вырабатывать: вырабатывать
эпидемия: эпидемии
поскольку: поскольку
сайт: сайта
патоген: патоген
каждый: каждого каждой
форма: форме
строение: строения
небольшой: небольшое
реальный: реальных
варьировать: варьировать
пунктирный: пунктирная
надежно: надежно
поддерживается: поддерживается
прогнозирование: прогнозирование прогнозирования
неизвестный: неизвестен
сигнал: сигналы
зараженный: зараженный
синий: синие
жертва: жертв
почва: почву
вирусный: вирусную вирусной вирусных
последний: последних
иммунологически: иммунологически
аминокислотный: аминокислотных аминокислотные
ограниченный: ограничен ограниченного
справляться: справляется
разный: разных разного разную разные разная
реактивность: реактивностью реактивность
несимметричный: несимметричной
патогену: патогену
график: график
отдельный: отдельных
месяц: месяца
зависеть: зависела зависит
встретиться: встретился
неодинаковый: неодинаково
серый: серая
патогеном: патогеном
группа: групп группы группам группами
прежнему: прежнему
естественный: естественный
выработка: выработке
иммунности: иммунности
единственный: единственной
проверка: проверку
ускользание: ускользание
линия: линии линия
циркулирующих: циркулирующих
делающих: делающих
обсуждаемой: обсуждаемой
концентрация: концентрация
глобальный: глобальном
узнающие: узнающие
скорость: скорость скорости скоростью
последовательность: последовательность
возникать: возникает возникают
статья: статьи
циркулировать: циркулируют
меняться: меняется меняться
рисунок: рисунок
итог: итоге
ранний: раннем
получить: получить
подтверждать: подтверждает
момент: момент
гомогенный: гомогенной
распространяться: распространяется
первоначальный: первоначального первоначальный
попадание: попадании
начинать: начинает начинали
непредсказуемой: непредсказуемой
миллион: миллион
генотип: генотипов
заражая: заражая
уклоняющихся: уклоняющихся
свой: свой
прежде: прежде
динамика: динамика динамику
либо: либо
лейкоцит: лейкоциты
оставаться: оставалась
потеряться: потерялись
предотвращать: предотвращает
участок: участках
целить: цель
частотный: частотная частотных частотные
называемой: называемой
относиться: относится
синтезировать: синтезировать
пики: пик
образ: образом
предел: пределах
поколение: поколения
неоднородность: неоднородности
потерять: потерять
единица: единице
мутационные: мутационные
симуляция: симуляций
восприимчивый: восприимчивых восприимчивый
незрелый: незрелых
концепция: концепции
автор: авторы
патогены: патогены
одновременный: одновременно
нейтрализующих: нейтрализующих
перестает: перестает
вариант: вариантов варианты вариант варианта вариантами варианту вариантом
мутация: мутации мутаций
высокий: высоких выше высока высокая высокую высокой
гемагглютинина: гемагглютинина
предположение: предположении
приводить: приводит
некоторый: некоторое некоторого
результат: результате
расположенный: расположены
изменчивость: изменчивость
факт: факта
справа: справа
нескольких: нескольких
система: системы системе
конкретный: конкретного конкретных
иллюстрация: иллюстрация
самый: самая
второй: втором
больший: большим большую
тратить: тратит
категория: категориях
дает: дает
согласовывать: согласовывает
фиксируются: фиксируются
белковый: белков
нейтрализация: нейтрализации
зависимость: зависимости
двух: двумя
свободный: свободной
деление: делению
демонстрировать: демонстрируют демонстрирует
статус: статуса статус
вести: ведут
истинный: истинного
успев: успев
антитело: антитела антителами антител
связывание: связывание
дело: дело
предсказуема: предсказуема
оказаться: оказалось
кровь: крови
ожидаться: ожидается
показывать: показывают показывает
узнающих: узнающих
переболевший: переболевший
меньшой: меньшую
какой: какое
который: которыми котором которым
быстрый: быстрее быстрой быстро
ожидание: ожидание
знать: знаем
называть: называют
достижение: достижения
постоянный: постоянна
реакция: реакциях
встречаться: встречался
кросс: кросс
рассматривать: рассматривает
попадать: попадает
моделирование: моделирования
последовательный: последовательным последовательна
хозяйский: хозяйской
достигнутый: достигнут
подчиняться: подчиняться
частичный: частично частичный
матрица: матрицей
сыворотка: сывороткой
иметь: имеет имеют
разделение: разделении
врожденный: врожденный
справиться: справиться
гуморальный: гуморальный
полагать: полагали
нейтральный: нейтральным нейтральные
похожий: похожего
человек: человека людей
представитель: представителей представители
квазинейтральную: квазинейтральную
гетерогенный: гетерогенной
заданный: заданными заданной
подстраиваться: подстраивается
память: памятью памяти
вызывать: вызывает
мутантного: мутантного
житель: жители
среда: среды среда
казаться: казалось
потенциал: потенциалом
следующий: следующий
реальность: реальность реальности
исследование: исследованиях исследования
рассматривающих: рассматривающих
мочь: можем
доля: доля
влияние: влияния влияние
другой: другом
адаптация: адаптации
показывающий: показывающий
перемешивание: перемешивание
снижаться: снижаются снижаться
скачок: скачок
большинство: большинство
зачастую: зачастую
подходящий: подходящие
интересный: интересно
получать: получают
создать: создали
разряд: разряд
фиксироваться: фиксироваться
ускользанием: ускользанием
поверхность: поверхности
способный: способные способны
сложность: сложности
разделить: разделить
эффективность: эффективность
исчезнувшие: исчезнувшие
знакомить: знакомит
повышается: повышается
применять: применяют
пожизненный: пожизненный
ним: ним
избыточный: избыточная
ускользания: ускользания
становиться: становится
напротив: напротив
скорый: скорее
признак: признаки
случать: случаем
обусловленный: обусловлена
невиданный: невиданный
инфекция: инфекций инфекции
увеличение: увеличение
клинк: клинк
например: например
вымирание: вымиранию
область: областях
галина: галина
вероятность: вероятность вероятностями
конкуренция: конкуренции конкуренция
тяжкий: тяжким
летальный: летальный
помощь: помощью
достигнуть: достиг достигли достигнуть
наибольший: наибольшее
гипотетический: гипотетическую
предыдущий: предыдущих предыдущего предыдущей
траектория: траектории траекторий траекторию
объяснить: объяснить
смочь: сможет смогли
достичь: достичь
черная: черная
шанс: шанса
очередь: очередь
условие: условиях
пул: пул
растет: растет
простейший: простейшем
начальный: начальной начальному начальная
удалось: удалось
забывать: забывает
рецептор: рецепторов рецепторы
поэтому: поэтому
разнообразие: разнообразие
предсказуемые: предсказуемые
впервые: впервые
малопредсказуемая: малопредсказуемая
преимущество: преимущество
связываться: связываются
делиться: делится
цепочка: цепочке
формируется: формируется
следовательно: следовательно
нажитый: нажитый
геномном: геномном
труд: трудом
генетический: генетических генетическом
видимый: видим
история: историю
задающимися: задающимися
континент: континентов
старый: старого
смоделировать: смоделировали
покрепче: покрепче
молекула: молекулы
круг: круг
меря: мере
знакомая: знакомым
благодаря: благодаря
популяция: популяции популяцию популяция популяциях популяцией
модель: модель модели
последствие: последствия
ландшафт: ландшафте
гораздо: гораздо
потомок: потомком
зафиксировались: зафиксировались
эволюционный: эволюционной
выделяться: выделяются
усложняться: усложняется
переходить: переходит
масштаб: масштабе
число: число
показать: показали
значение: значений значение
восприимчивость: восприимчивость
замещать: замещают
середина: середине
сложный: сложная
приобретенного: приобретенного
последующий: последующая последующее последующие
асимметричности: асимметричности
степень: степени
бегущей: бегущей
патогена: патогена
грипп: гриппа грипп гриппом
сторона: стороны сторону
подобный: подобно
первый: первым первом
привести: привести
идея: идеи
формирование: формирование
судьба: судьбу судьба
роль: роль
человеческий: человеческой
перестать: перестать
требоваться: требуется
предполагать: предполагает
циркулировавшие: циркулировавшие
антигенные: антигенные
эволюция: эволюцию эволюции эволюция
счет: счет
волна: волны
предсказать: предсказать
компартментами: компартментами
черные: черные
путь: пути
закрепиться: закрепиться
ученые: ученые
группироваться: группируются
вторжение: вторжение
эпидемиологический: эпидемиологическую
относительный: относительно
эпитопных: эпитопных
сбивать: сбивать
штамм: штаммов
новый: новых новые новом нового новый
вирус: вируса вирусу вирус вирусы вирусов вирусом вирусами
белка: белка белки белках
заражение: заражении заражение заражения
ослаблять: ослабляет
бурный: бурного
приобретать: приобретать приобретает
такой: таких таком таким
отсутствие: отсутствие
сравнение: сравнению
медленный: медленно
клеточный: клеточный
следствие: следствие
уровень: уровне
толстый: толстая
адаптивный: адаптивный
возраст: возраста возраст возрасте
отмечать: отмечают
иммунитет: иммунитет иммунитета иммунитету
возрастной: возрастной возрастные
симптом: симптомы
схожий: схожи
полиовирус: полиовирус
влиять: влияет
близкий: близких
появившиеся: появившиеся
схема: схема
создает: создает
ликвидированы: ликвидированы
благодатный: благодатную
исследователь: исследователи
работа: работа
рнк: рнк
положительный: положительного
возникший: возникший
окончательный: окончательный
производить: производят
устойчивость: устойчивость
сконструированных: сконструированных
инфицированный: инфицированный
испортить: испортить
заражающих: заражающих
болеть: болел
расширенный: расширенную
появившийся: появившийся
репродукция: репродукции
предсказуемой: предсказуемой
адаптивные: адаптивные
учитывать: учитывает
равновесный: равновесную равновесной
зависящей: зависящей
истощается: истощается
возможный: возможен
весь: всей
ускользающего: ускользающего
эволюционировать: эволюционируют
средний: средняя среднее
приведет: приведет
сценарий: сценарии
