характеристика: характеристик
типовых: типовых
гомеостаз: гомеостаз
гексагональная: гексагональная
сан: сан
наибольший: наибольшей
источник: источники
километр: километров
стрессовых: стрессовых
популярный: популярных
насколько: насколько
пособие: пособия
видеть: видели
обсуждаемой: обсуждаемой
сайт: сайта
расположить: расположить
диаграмма: диаграммах
переход: переход
рабочий: рабочем рабочего
этанол: этанол
двух: двумя
глубоководный: глубоководные глубоководных
жидкий: жидкие жидкого
отличие: отличие
липидные: липидные
рост: роста
приготовить: приготовили
счет: счет
малый: малых малой
ничуть: ничуть
вид: виде виды видов видами
следовательно: следовательно
занявшись: занявшись
внимание: внимание
освещаться: освещается
штамм: штамм
поэтому: поэтому
шибаева: шибаева
нормальный: нормальный
проблема: проблемой
изученных: изученных
базальной: базальной
архиважной: архиважной
тепловодными: тепловодными
липида: липида
слева: слева
функциональном: функциональном
липидов: липидов
побережье: побережья побережью
наработки: наработки
проницаемость: проницаемости
мелководный: мелководные мелководных мелководного мелководными
расселившийся: расселившийся
пластинка: пластинка пластинкой
живущий: живущих
своем: своем
исследователь: исследователи
филогенетической: филогенетической
базальная: базальная
жидкокристаллическая: жидкокристаллическая
негативный: негативное
справляться: справляются
весь: всей
своеобразный: своеобразного
липиды: липиды
гексагональную: гексагональную
защитный: защитных защитного
частность: частности
путь: пути
мозаика: мозаикой
добавлять: добавляет
задались: задались
амин: амина амин
решать: решает
животное: животных животные
автор: авторы
слоистый: слоистого
олигосахаридов: олигосахаридов
филогенетическая: филогенетическая
атмосфера: атмосфер
елена: елена
первый: первые
свойство: свойства свойство свойстве
восстанавливать: восстанавливать
зависеть: зависит
ацильные: ацильные
гипотеза: гипотезу гипотезы гипотеза
радиус: радиус
независимый: независимо
поддерживать: поддерживать поддерживают
вполне: вполне
клеточный: клеточных клеточная клеточной клеточные
организм: организмов организмы
кристалл: кристаллы кристалла
лизосомный: лизосомный
образование: образовании
диффузия: диффузия
десяток: десятки
изощренных: изощренных
разбираться: разбирались
комплекс: комплекс
нерабочий: нерабочее
импульс: импульса
ушедших: ушедших
вода: водам
класс: классов
липидном: липидном
цифра: цифрами
хвост: хвостами хвоста
написаны: написаны
возможность: возможности
составив: составив
меря: мере
полоть: поли
нить: нити
сливаться: сливаться
востребованную: востребованную
липосомного: липосомного
прекращаться: прекращается
море: морей
сравнение: сравнению сравнении
мембранные: мембранные
обеспечивать: обеспечивает
процесс: процессе
низкий: низкой
текучий: текучей
основа: основой
например: например
имеющийся: имеющихся
предложить: предложили
свернуться: свернуться
выпрямляться: выпрямляются
область: области
отграничить: отграничить
размножаться: размножаться
консенсус: консенсус
задуматься: задуматься
находиться: находится
другой: другими
четырехкилометровой: четырехкилометровой
показатель: показатели
базироваться: базировалась
частить: части
матрица: матрицы
фосфолипиды: фосфолипиды
определенной: определенной
провести: провести
полисахариды: полисахариды
липидомы: липидомы
использовать: использовать
белка: белки белок
живой: живых живые
морфологический: морфологических
бислой: бислой
клетка: клеткам клетка клетки клетку
исследовательский: исследовательские
вероятный: вероятно
арктический: арктических
гомеостатической: гомеостатической
синтезировать: синтезировать
решение: решение
появляться: появлялось
мембрана: мембран мембрана мембраны мембранами мембранах мембране
привлекать: привлекают
изображение: изображение
вставленной: вставленной
слоев: слоев
условие: условиях условиям
демонстрировать: демонстрирует
синапсах: синапсах
поверхность: поверхности поверхность
монослоя: монослоя
позитивный: позитивное
принцип: принцип
вспомнить: вспомним
гребневик: гребневики гребневиков гребневиками гребневик гребневика
пойманных: пойманных
восточный: восточному
снятие: снятия
большой: большой
съемка: съемка
липосомами: липосомами
поместить: поместили
расширять: расширяют
снижаться: снижается
новый: новое новая новый
одновременный: одновременно
группа: группы
концентрация: концентрация
увеличиваться: увеличивается
особенный: особенные
институт: института
доказывать: доказывает
повышение: повышении
широкий: широком
контрольный: контрольных
налево: налево
редкий: реже редка
столько: столько
джейкоба: джейкоба
удивительный: удивительно
редуцироваться: редуцировалась
выявить: выявили выявить
отличаться: отличается отличались
расти: расти
вставленным: вставленным
вплоть: вплоть
холестерики: холестерики
коллекция: коллекция
линия: линиях линиям
бислоя: бислоя
цель: целью
сконструировать: сконструировали
адаптация: адаптации адаптацию
интегральный: интегральный
работа: работ
посмотреть: посмотрели
собираться: собираются
слово: словами
фосфолипидов: фосфолипидов
превращение: превращение
смесь: смеси
отрезка: отрезки
высокий: высокому высокого высокое выше высоким высокой высоких
являться: являются является
обладать: обладает обладал обладали
изменение: изменения
большинство: большинство
бывать: бывают
иметь: имеет имеют
жидкость: жидкость
биологический: биологических
данные: данных
глубокий: глубоким
показать: показал показали
переходить: переходит переходить
поддержание: поддержание поддержания
становиться: становится
гидрофобности: гидрофобности
кривизна: кривизна кривизну кривизной кривизны
строгий: строгую
полисахарид: полисахарид
способность: способность
плазменил: плазменил
список: спискам
видимость: видимости
инструмент: инструмент инструментов
домна: домен
цитоскелета: цитоскелета
пузырёк: пузырьков
обращать: обращают
гелевую: гелевую
углеводородный: углеводородными
схематический: схематическое
понятный: понятный
пузырьковый: пузырьковый
столбик: столбики
позволяющий: позволяющий
рана: ран
использованный: использованных
важный: важнее важен
свойственный: свойственно
антиоксидантными: антиоксидантными
колокол: колокола
разный: разных
задача: задача задачу
иметься: имеются
компонент: компонент
строение: строения
конус: конус
согласный: согласно
ученые: ученые
среди: среди
видный: видно
поддерживаться: поддерживаться
состояние: состояние состоянии состояния
результат: результате
каждый: каждого
перегнать: перегнал
липидных: липидных
уметь: умеет
научный: научно
холодноводными: холодноводными
лаборатория: лаборатории
выясниться: выяснилось
создает: создает
выравниваться: выравниваются
поведение: поведения
обзор: обзор
способ: способами
гораздо: гораздо
липид: липид
различие: различие
очевидный: очевидной
устойчивость: устойчивости устойчивость
уловить: уловить
проверка: проверки
светлый: светло
сидячий: сидячий
сохранять: сохранять
ламеллярная: ламеллярная
рисунок: рисунок
жизнеспособный: жизнеспособным
параметр: параметрам
показывать: показывает
застывающей: застывающей
текучесть: текучестью текучесть
сравнить: сравнить сравнили
адаптивный: адаптивный
иллюстрирующая: иллюстрирующая
должный: должна должен
затвердевать: затвердевает
боковой: боковой
сфера: сферу
аппарат: аппарат
единственный: единственные
освоить: освоили
механизм: механизм механизма
переходя: переходя
самый: самым
дефект: дефектах
работать: работали работать
сородич: сородичей
липидной: липидной
функциональные: функциональные
неразветвленными: неразветвленными
предотвращать: предотвращать предотвращают
вести: ведут
подобный: подобных подобную
давление: давлению давления давление давлений давлением давлениям давлениях
иной: иными иного иным
арктики: арктики
фаза: фазы фазу фаза
материал: материале
палеонтологический: палеонтологического
головка: головки
жидкокристаллической: жидкокристаллической
олигосахарид: олигосахарид
разветвленными: разветвленными
наличие: наличием
молекулярный: молекулярный молекулярных молекулярные
важность: важность
холодноводных: холодноводных
серый: серые
липидомов: липидомов
американский: американские американского
увеличение: увеличении увеличением увеличение
природа: природа
распоряжение: распоряжении
липидного: липидного
наймарк: наймарк
семейство: семейства
упорядоченность: упорядоченность
вывести: вывести
уровень: уровня уровень
остановиться: остановились
замена: замену
обсуждаемом: обсуждаемом
понижаться: понижается
внутриклеточный: внутриклеточный
знаменатель: знаменатель
заменять: заменяют
жизнь: жизни
фото: фото
построить: построили
гликопротеин: гликопротеин
глубина: глубин глубине глубинах глубину
обычный: обычная обычном обычных обычными
вязкость: вязкостью
подобрать: подобрать
позволяющие: позволяющие
удобный: удобен
состав: составе состава
ламинарного: ламинарного
транспорт: транспорт транспорта
увеличивать: увеличивают
заключить: заключить
ведущая: ведущие
обитание: обитания
функциональность: функциональность
образ: образ образом
публика: публики
какой: какие
гель: геля гель
ученых: ученых
липосомы: липосомы
размер: размера
журнал: журнале
схема: схема схеме
неожиданный: неожиданные
включать: включала
монослой: монослой
отвечать: отвечает отвечают
фазовое: фазовое
специалист: специалисты
обитатель: обитателей обитатель
одно: одно
повышенный: повышенное
исследовать: исследовали
абиссали: абиссали
набор: набором
кассета: кассетой
зеленые: зеленые
называемый: называемый
сразу: сразу
попроще: попроще
различный: различного
больший: большей
раз: раза
синтез: синтеза синтезом
стремиться: стремится
решить: решили
любой: любая любых
погибать: погибает
фосфатидил: фосфатидил
ацильной: ацильной
прямой: прямая
чрезвычайный: чрезвычайно
представитель: представители
структура: структур
мелководье: мелководий мелководьях
океан: океана
атлантики: атлантики
смысл: смысле
измерение: измерения
университет: университета
атлантический: атлантического
нервный: нервного
исследование: исследование исследования исследовании
специфичность: специфичность
трем: трем
библиотека: библиотеки
оценить: оценить
несложный: несложно
адаптаций: адаптаций
выйти: вышло
белковый: белков
изобрести: изобрела
приобретать: приобретают приобретает
включены: включены
передача: передачу
иначе: иначе
бактерия: бактерии бактерий
расшифровка: расшифровкой
диапазон: диапазон диапазоне
зрелищный: зрелищный
теплых: теплых
целостность: целостности целостность
подстилающая: подстилающая
ключевой: ключевое
трудный: трудно
всякий: всякие
предположить: предположили
вместе: вместе
искривление: искривления искривление
издание: изданиях
умалять: умаляет
фазовых: фазовых
эволюционный: эволюционных эволюционным
означать: означает
необходимый: необходимо
слой: слоя слой слои
изгиб: изгиб
диего: диего
данный: данной данное данный
терять: теряет теряют
книга: книг
признак: признак
холодный: холодно холодных холодной
факт: факты
заметный: заметно
сужаться: сужается
экспериментальный: экспериментальных
отмечать: отмечают
крайний: крайней
эпителиальные: эпителиальные
эволюция: эволюции
руководство: руководством
винникоффа: винникоффа
жидкокристаллическом: жидкокристаллическом
попытаться: попытались
молекула: молекул
содержание: содержанию содержание содержания
многоклеточный: многоклеточных
справа: справа
липидный: липидный
обозначены: обозначены
шельф: шельфа
функция: функциях функциями
второй: второго
нацело: нацело
общий: общий
тема: теме темы
актуальность: актуальность
температура: температура температуре
мембранного: мембранного
экземпляр: экземпляров
тепловодных: тепловодных
застывший: застывшую
статья: статью статьи статья
поверхностный: поверхностный
отдельный: отдельно
такой: таких таком таким
специфический: специфических
проверить: проверить
