ответ: ответ
посягательство: посягательств
выгодный: выгодно
бороздка: бороздками
война: войны
ученых: ученых
навеки: навеки
гребенка: гребенка
спустя: спустя
помощь: помощью
эгоистичный: эгоистичный
спариваться: спариваться спариваются
кот: котов
равный: равно
сенсорный: сенсорные
образец: образец
яйцо: яиц
вполне: вполне
создание: создания
позволять: позволяют
пола: поле полами
партнерами: партнерами
клопик: клопиков
оплодотворения: оплодотворения
жизнеспособный: жизнеспособной
отдельный: отдельными
ухажеров: ухажеров
искусство: искусства
другой: другом
адаптаций: адаптаций
вставить: вставить
защищать: защищают
подруга: подругам
жук: жуки жуков
относительный: относительно
способный: способен
копулировал: копулировал
пласт: пластами
минувший: минувших
некоторые: некоторых некоторым
подчас: подчас
многократный: многократных
погибать: погибает
демонстративный: демонстративно
храм: храмов
копуляций: копуляций
веселую: веселую
миро: мире
млн: млн
следовать: следовал
копулирующих: копулирующих
автор: авторы авторов
использовать: используют
рисунок: рисунок
палеоэнтомологи: палеоэнтомологи
возникать: возникали
бирмите: бирмите
захлестывало: захлестывало
средний: среднем средние средней средняя
путь: путях
верх: верхом
удалось: удалось
лишний: лишних
плавунец: плавунцы плавунцов
злодей: злодеи
бурмогерриса: бурмогерриса
примечательный: примечательно
плавающие: плавающие
максимум: максимум
роман: романы
смолистый: смолистыми
отнюдь: отнюдь
честь: чести
ученые: ученые
откидывать: откидывают
ископаемое: ископаемом
мелового: мелового
стрелок: стрелками
реконструкция: реконструкция
партнершу: партнершу
задаться: задаться
ряд: ряду
место: места
аппетит: аппетита
доставлять: доставляет
поединок: поединок
звучный: звучными
всплыть: всплыть
спаривающейся: спаривающейся
поэтому: поэтому
насилие: насилия насилию насилии
научить: научил
перекусывать: перекусывает
трехмерном: трехмерном
подсчитать: подсчитали
насиловать: насиловали
согласие: согласию согласия
ним: ним
существенно: существенно
уровень: уровнях
маркиз: маркиза
оборона: оборону
вымерший: вымершему
живущий: живущих
пронизывать: пронизывает
брат: брат брата
ограничена: ограничена
погребенные: погребенные
пара: парой
успевать: успевает
детство: детства
данный: дано
состояние: состоянии
хватательный: хватательной
задний: задних
фреска: фрески
говориться: говорится
распрямлять: распрямляют
непростой: непросто
перераставшую: перераставшую
дождем: дождем
словно: словно
красивый: красиво
стать: стали
обед: обед
разгул: разгул
опубликован: опубликован
ходить: ходить
убийца: убийцы
предпочтение: предпочтениях
коготок: коготок
обнаружить: обнаружили
дарвин: дарвин
превратиться: превратилась
древние: древних
исследование: исследованиям
завлекающие: завлекающие
одновременный: одновременно
нежелательный: нежелательных
миллион: миллионы
излишний: излишние
колышковидных: колышковидных
больший: больших
попадание: попадание
писать: писал
стоялый: стоял
жертва: жертвами
свой: свой
отнести: отнести
находиться: находятся
затопленном: затопленном
считаться: считалась
фото: фото
предыдущий: предыдущего
свидетельствовать: свидетельствуют
потеря: потерями
водный: водных водной
вынужденный: вынуждена
смешиваться: смешивалась
показаны: показаны
отчаянный: отчаянный отчаянные
стратегия: стратегию
территориальный: территориальным
групповой: групповую
ненужный: ненужных
родственный: родственному
воробьев: воробьев
сталкиваясь: сталкиваясь
период: периода
палеоэнтомологам: палеоэнтомологам
относиться: относятся
надсемейство: надсемейство
голень: голени голень голенях
выигрывать: выигрывает
причем: причем
образоваться: образоваться
граффити: граффити
насильник: насильники насильника
разрешать: разрешают
глаз: глаз
точный: точно
барабанить: барабанить
высокий: высока
устраивать: устраивали
межполового: межполового
толкунчики: толкунчики
утеха: утех
интимный: интимные
натека: натека
правда: правда
родитель: родители
скорость: скорость
протекать: протекала
отрезок: отрезков
александр: александр
сопротивляться: сопротивляться
пленкой: пленкой
колебание: колебания
проследить: проследить
противодействие: противодействия
партнерш: партнерш
бурмогеррисов: бурмогеррисов
далеком: далеком
спариться: спариться
занимать: занимает
рисковать: рискует
разобраться: разобраться
тремя: тремя
ежедневно: ежедневно
скрываться: скрывается
положительный: положительных
сравнение: сравнению
рыба: рыбы
новый: новые
пошлить: пошли
масштабный: масштабных
обсуждаемой: обсуждаемой
сопротивляющийся: сопротивляющуюся сопротивляющейся
белая: белыми
удерживать: удерживают
присасываться: присасываться
сохранившиеся: сохранившиеся
кусок: кусках кусок куске
черными: черными
янтарь: янтаре янтаря янтарь
меркнуть: меркнут
изнасилование: изнасилований
единственный: единственные
взгляд: взгляд
исключено: исключено
кутить: кучу
первый: первого
приспособление: приспособлениями
потомство: потомства
морской: морском морские морской
стихия: стихии
шантаж: шантажа
история: историю
спаривающихся: спаривающихся
поминутный: поминутно
бороться: борются
энтомолог: энтомолог
изучение: изучения
заросль: зарослях
катать: катать
обеспечено: обеспечено
художественный: художественная
статья: статьи
час: часа
заниматься: занимались
отмечены: отмечены
близкий: ближе
заметный: заметных
случайный: случайно
ограниченный: ограниченное
конец: конец концом
лежать: лежит
взгромоздившись: взгромоздившись
например: например
незваный: незваным
одну: одну
докинза: докинза
делать: делают
завладевать: завладевать
взгромоздиться: взгромоздиться
передний: передних передняя передней переднее
меловые: меловые
книга: книге
дело: дело
расти: рос
связь: связь
роува: роува
привлекая: привлекая
признак: признаков
наглый: наглых наглые
возможный: возможно
заманивать: заманивают
самец: самцы самцов самцом самцами самцу самец самцам самца
сперматозоид: сперматозоидов
поскольку: поскольку
принятый: принято
гонка: гонка
прицепиться: прицепился
выбирать: выбирать
столь: столь
битва: битвы битва
воздух: воздухом
хищный: хищных хищные
отбиваясь: отбиваясь
водомеркам: водомеркам
пар: паре парами пары пар пара
застыть: застыли
серьезные: серьезные
пищать: пищу
похотливый: похотливых
брачный: брачные
серенада: серенадами
бывать: бывают
щетинок: щетинок
вероятный: вероятно
забота: заботы
половой: половую половых
пруд: пруда пруду
откуда: откуда
любовный: любовной любовных
возможность: возможность
смотреть: смотреть смотрел
исключительный: исключительные
чей: чей
толстый: толстых
помогать: помогало
дожидаясь: дожидаясь
который: которым котором
особь: особями особей
американский: американской
образ: образом
соитию: соитию
низкий: низкой
раз: раза
править: правило
бурмогеррисом: бурмогеррисом
характерный: характерен характерно
родительский: родительской
ричарда: ричарда
присоска: присоски
своем: своем
обитать: обитали
озерах: озерах
межполовой: межполовой
никакой: никакими никаких
передвижение: передвижения
слой: слое
растительность: растительности
одиночный: одиночной одиночными одиночный одиночным
снизу: снизу
развернуться: развернулась
одна: одна
затрата: затраты
арнквиста: арнквиста
божественный: божественного
покрытый: покрыта
часы: часы
водомерок: водомерок
судя: судя
начинать: начинают
диморфизм: диморфизм
ловкость: ловкость
производя: производя
хищник: хищнику хищников
сидящий: сидящий
рука: руки
аммонит: аммониты аммонит
организм: организмы
целовать: целую
животное: животные животных
многу: многу
прилипнуть: прилипла
переднеспинка: переднеспинка
водоеме: водоеме
предшествовать: предшествует
знакомая: знакомых
дать: дам
попасть: попала
откладки: откладки
насекомое: насекомых насекомые
самка: самок самки самкам самкой самка самке самками самку
отпихивать: отпихивает
спина: спине спину
относящихся: относящихся
длинноногость: длинноногость
избежать: избежать
ученым: ученым
остается: остается
парочка: парочку
поместить: поместили
деталь: детали
произведение: произведением
иметь: имел
результат: результатов
вообще: вообще
вопрос: вопросом
скорый: скорее
незначительный: незначительными
приносить: приносят
какой: каким каких
располагаться: располагаются
подходящий: подходящие
отличаться: отличались
сбросить: сбросить
соревнуются: соревнуются
путем: путем
треугольник: треугольниками
избегать: избегают
меловом: меловом
пытаться: пытались пытаются пытается
активность: активность
искать: искать
сухопутный: сухопутные
меловых: меловых
отношение: отношения отношениях
считать: считает
сверху: сверху
предок: предки
древний: древнем
участок: участок участке
китайский: китайские
особый: особыми особым особые
смола: смолы смолу смола
ограничиваться: ограничиваются
лёгкий: легче
разный: разными разных
пространство: пространстве пространств
конечность: конечностей конечности
принуждать: принуждали
известный: известен известны известных
редкий: редкая
изобретать: изобретают
число: число числа
ухаживать: ухаживать
поверхностный: поверхностного
получиться: получилось
эпоха: эпох
синий: синими
включая: включая
многие: многие
резвиться: резвились
тело: тело
оргия: оргию
бурмогеррисы: бурмогеррисы
деревенский: деревенским
хватать: хватают
подобный: подобно
петр: петр
тот: той
настоящий: настоящая настоящим
похабный: похабные
красный: красными
спаривающиеся: спаривающиеся
конфликт: конфликт конфликта конфликтов
шторм: штормов
сплошной: сплошным
сцеплены: сцеплены
классический: классическим
прямой: прямая прямо прямое
воспитание: воспитанию
подумать: подумать
строка: строки
смешной: смешно
сад: сада
очередь: очереди
брюшко: брюшка брюшко
мочь: могли
бирманский: бирманском бирманского бирманский
эротический: эротические эротических
нестабильный: нестабильной
помпеи: помпеи
посчастливиться: посчастливилось
вечер: вечером
римлянин: римлян
вода: воды воде водой
проводить: проводить
длиться: длится
проникнуть: проникнуть
соленостью: соленостью
гармоничный: гармоничным
тихий: тихим
брюшной: брюшного
обойти: обойти
испугавшись: испугавшись
разузнать: разузнать
дарвиновской: дарвиновской
зажимчиком: зажимчиком
играть: играют
двухмерном: двухмерном
генитальный: генитальный
тонкий: тонкие
трихоботрии: трихоботрии
погрязнуть: погрязли
природа: природа природу природе
энергия: энергии
увильнуть: увильнуть
нижний: нижней
обороняться: обороняются
партнера: партнера
муха: мухи
идиллия: идиллией
насильственный: насильственным
натяжение: натяжения
гладышей: гладышей
сегмент: сегмента
давать: дают
вид: видов виду виды вида видам вид
напротив: напротив
соперник: соперников
копулирующие: копулирующие
подарок: подарки
основный: основная
фактически: фактически
кавалер: кавалером
прошлое: прошлом
предположить: предположили
поведение: поведение
вписываться: вписывается
пейзажный: пейзажный
название: названием
развернуть: развернут
беречь: берегу
лапка: лапках лапка
сидеть: сидит сидеть сидели
древность: древности
копуляции: копуляции
сохраняться: сохраняются
ствол: стволами
гробик: гробик
сразу: сразу
свойственный: свойственно
подпрыгивая: подпрыгивая
жизнь: жизни
водомерками: водомерками
охарактеризовать: охарактеризовал
вместе: вместе
возраст: возрастом возраст
внимание: внимание
свалить: свалит
одному: одному
явный: явно
благодаря: благодаря
держать: держат
отнесен: отнесен
длинный: длиннее
сексуальный: сексуального сексуальной сексуальном сексуальную
множество: множеством
минута: минут минуты
подсемейство: подсемейств
получить: получить
спрятаться: спрятаться
бок: бок
сила: силами
помочь: помогли
составлять: составляет
строение: строении строения
прижиматься: прижиматься
достаточный: достаточно
биолог: биологов
становиться: становятся
сложнее: сложнее
захват: захвата
территория: территорию
ситуация: ситуации
среди: среди
милая: милых
ненасытный: ненасытного
нога: ноги ногами ногах
вместо: вместо
бушевать: бушевал
помпеях: помпеях
деликатный: деликатную
побережье: побережье
мнение: мнению
источник: источник
вертикальный: вертикально
несмотря: несмотря
секс: сексом
сладкий: сладкую
небольшой: небольшом
обозначение: обозначения
маленькая: маленьких
вступать: вступают
процесс: процессе
лока: лока
позволяющие: позволяющие
иметься: имелись
полова: полов половой
угодить: угодить угодили
тайный: тайны
сантиметровом: сантиметровом
водоема: водоема
весьма: весьма
мерка: меркам
ген: ген
мера: меры
мастабных: мастабных
плотность: плотность
группа: группу группами группы
день: дней дни
малу: малу
обзавестись: обзавелись
эпический: эпическая
терять: теряет
выступ: выступом
охраняя: охраняя
поток: потоком
открытый: открытой
находка: находка находки
шокирующие: шокирующие
игра: игру
написан: написан
сторона: стороне стороны
вспрыгивать: вспрыгивают
найти: нашли найти
морфологический: морфологических
модифицированные: модифицированные
докинз: докинз
защита: защиты
сзади: сзади
добыча: добычей
клоп: клопов
поза: позах
выверенным: выверенным
взаимный: взаимному
надкрыльях: надкрыльях
главное: главным
сложный: сложный
находить: находят
рис: рис
скользить: скользят
повиновение: повиновению
продуцирует: продуцирует
закрыть: закрыли
изогнутый: изогнута изогнутые
служить: служили
продвинутый: продвинутые
спаривание: спариваний спаривание спаривания
приходиться: приходилось приходиться
семейный: семейные
передает: передает
межполовых: межполовых
сперма: сперма
голова: голова
получаться: получается
янтарный: янтарном янтарный
современный: современных современным
щетинки: щетинки
кузнечик: кузнечики
назойливый: назойливых
изображение: изображение
гребенкой: гребенкой
бедро: бедро
лужа: лужи лужах
жить: живут
контакт: контакт
большой: большого
мирный: мирно
поверхность: поверхности
мешать: мешают
неудобство: неудобства
подпрыгивать: подпрыгивают
палеоэнтомологии: палеоэнтомологии
конкуренция: конкуренция
уплощено: уплощено
глава: глава
отличие: отличие
петров: петров
сайт: сайта
такой: такую
стащить: стащило
кувыркаться: кувыркаться кувыркаются
манифест: манифестом
длина: длина длине
полагаться: полагаться
ставшей: ставшей
отсутствовать: отсутствует
горана: горана
камень: камнями
исходить: исходит
женишки: женишки
назвать: назвали
парк: парк
процитированное: процитированное
пытаясь: пытаясь
способ: способы
фаллос: фаллос
практически: практически
обязанность: обязанностей
объект: объектом
подробность: подробности
вожделение: вожделения
модельный: модельным
остальное: остальных
лес: лесу лес
высказывание: высказывание
опасность: опасность
вооружение: вооружений
гениталии: гениталии
самый: самые
дом: домах
семейство: семейству
друг: друг
частота: частотой
тесный: теснее
растение: растения
пример: примерами
совокупляться: совокупляться
эволюционный: эволюционная
доминиканском: доминиканском
одном: одном
водомерки: водомерки
производить: производить
