перемещен: перемещен
разветвленные: разветвленные
служить: служат служит
просвечивать: просвечивают
выращивая: выращивая
водоема: водоема
голова: голове головы
поиск: поиски поисках
действующий: действующего
глаголев: глаголев
личинка: личинки личинок
ненамного: ненамного
занимать: занимают
местонахождение: местонахождение местонахождении
соотношение: соотношение
засуха: засухи
считаться: считаться
ходящие: ходящие
нить: нити
западно: западно
пятидесяти: пятидесяти
найдено: найдено
самец: самца самцы самцов самец
названный: названа назван
текст: текста
несколькими: несколькими
свой: своим
юго: юго
рис: рис
кожный: кожных кожное
находить: находили находить
червягой: червягой
добавить: добавили
ход: ходы
пенистый: пенистую
блюдо: блюда
болотный: болотные
примерно: примерно
клык: клыков
экземпляр: экземпляр
назвать: назвать
окрашенные: окрашенные
мировой: мировой
какой: каких какие
соавтор: соавторов
единый: единую
одном: одном
криптических: криптических
умеренный: умеренных
ложноугря: ложноугря
лазающие: лазающие
неразветвленную: неразветвленную
скелет: скелета
костя: кости
описание: описания
попалить: попали
неплохой: неплохо
среда: среду среды
замок: замки
часть: часть
гулять: гулять
черные: черные
происхождение: происхождением
ранее: ранее
древо: древо
животное: животных животным
вряд: вряд
орех: орехи
отсутствовать: отсутствуют
водоемах: водоемах
изучение: изучения изучение
местообитания: местообитания
вертикальный: вертикальный
туннель: туннель
сергей: сергей
уступать: уступают
большинство: большинство
гонада: гонада
ротоглоточной: ротоглоточной
вьетнам: вьетнаме
зарываться: зарываются
полностью: полностью
позвоночный: позвоночных
полный: полно полное полных
река: рек реки реке рекой
перенесен: перенесен
современный: современной
вид: вид виды видов вида виде видом видами
биомасса: биомассе
одним: одним
распространение: распространения распространением
регион: региона
угорь: угри угорь
одних: одних
плантация: плантации
внимание: внимание
брать: брать
доход: доход
сестринский: сестринский
ученые: ученые
монография: монографии
усиливать: усиливает
туловищных: туловищных
конический: конических
ближайший: ближайшего ближайшими
немалый: немало
переходить: переходит
длинный: длинное
жаберный: жаберные жаберных жаберный
выглядеть: выглядит
гнездо: гнездо
выявленные: выявленные
изучать: изучают
лепидосирены: лепидосирены
индия: индии
позвоночник: позвоночник
рыбак: рыбаков
необычный: необычны необычного необычных
легкие: легкие
кухия: кухия
инвазивные: инвазивные
берег: берегам
популяция: популяциях популяции
лопата: лопатой
прозрачный: прозрачные
должный: должен
тело: тело тела теле
африканский: африканским африканского африканскими
челюсть: челюсти
вновь: вновь
горизонтальный: горизонтальную горизонтальные
подготовка: подготовке
поражать: поражают
четвертой: четвертой
шея: шею
течение: течение
больший: большая большие
япония: японии
нормальный: нормальные
препарат: препараты
оплодотворять: оплодотворяет
ясность: ясности
сторожить: сторожит
момент: моменту
жизнь: жизни
боковой: боковой
вентральную: вентральную
сенотов: сенотов
сквозь: сквозь
тайланде: тайланде
относиться: относится относятся
исходный: исходной
найти: найти
индийский: индийского
геном: геномам генома
видовой: видовой
определенного: определенного
используются: используются
нога: ногах
пример: пример
прибрежье: прибрежье
вести: ведут
редуцированы: редуцированы
трех: трех
остеологический: остеологические остеологическим
кой: кое
маленькая: маленькие
близкий: близкого
населяющих: населяющих
взятых: взятых
освоить: освоить
змеей: змеей
написать: написал
копаться: копалась копаются
поведение: поведении поведение
прикрепляться: прикрепляются
касаться: касается
житель: жителей
каждый: каждом
смахивающих: смахивающих
английский: английском
змеегрудый: змеегрудый
охранять: охраняют
заботиться: заботится
размножаться: размножаются размножается размножаться
уходить: уходит
молекулярный: молекулярные
млекопитающий: млекопитающие
источник: источником источник
активный: активного активно
мексиканский: мексиканским
глубокий: глубоко
биоразнообразия: биоразнообразия
отмечать: отмечают
разнообразию: разнообразию
парный: парных
пята: пятой
крупный: крупные крупных
непосредственный: непосредственной
брисас: брисас
семенник: семенник
кухня: кухни
обсуждаемой: обсуждаемой
рот: рту
являться: являются
складка: складок
третий: третьей третьих третья третьего
отверстие: отверстия отверстие
частичный: частично
построить: построили
ареал: ареал ареалы
воздушный: воздушные воздушных
тропический: тропических
владелец: владелец
яичник: яичнике
белка: белок
полезный: полезны
новый: новый новая новом нового новых новые
попутный: попутно
смочь: смогли
способный: способны
глотка: глотке
розовый: розовая
ява: яве
голубцову: голубцову
малёк: малька
число: числу числа число числом
остальное: остальных
карибского: карибского
обусловленный: обусловлена
план: плане
живет: живет
форма: форме
пресноводный: пресноводных
колодец: колодца
каменистый: каменистой
распространены: распространены
морской: морскими
формально: формально
местообитание: местообитание
приходиться: приходится
плавательный: плавательного
пузырь: пузыря
осторожнее: осторожнее
посттемпоральная: посттемпоральная
филогенетическое: филогенетическое
кожа: кожей кожу коже
пояс: пояс пояса
креветка: креветками
найдены: найдены
светлый: светлыми
упростить: упростят
джорджию: джорджию
обнаруженный: обнаруженный
округлый: округлой
выкопаны: выкопаны
мокрый: мокрой
пятый: пятого
представлять: представляет
бразилия: бразилии
благодарный: благодарен
кислород: кислорода
американский: американские
напоминающие: напоминающие
русский: русский
азия: азии
настоящий: настоящим настоящему
впервые: впервые
честь: честь
внешний: внешне внешнего внешним
постоянный: постоянно
переводиться: переводится
поле: поля
червяг: червяг
точка: точке точек точки
гермафродит: гермафродиты
держать: держит
думать: думаю
честный: честному честный
рекапитуляции: рекапитуляции
эстуариях: эстуариях
затапливались: затапливались
побывать: побывать
вырастать: вырастает
физиология: физиологией
сша: сша
луч: лучей
состав: составе
карлик: карликом
азиатский: азиатский
заселение: заселение
ротоглоточная: ротоглоточная
населять: населяют
создает: создает
протоптерусами: протоптерусами
гора: горы
сужающийся: сужающийся
расположенный: расположен
настолько: настолько
фермер: фермеров
продаваться: продаются
весьма: весьма
желанный: желанная
разнообразный: разнообразны
многие: многие многими многих
камеруна: камеруна
обнаружен: обнаружен
подтверждать: подтверждает
метода: методы метод
пресный: пресных
экология: экологией
короткий: короче
сохранение: сохранения
признак: признаки
пойманных: пойманных
вероятный: вероятно
песчаный: песчаной
автор: авторы автор
бразильский: бразильского
описать: описали описать
бросаться: бросается
практически: практически
дуга: дуг дугах
мешок: мешка
соединяться: соединяется соединяются
аквакультуры: аквакультуры
прыгун: прыгуны
верхний: верхней
заповедник: заповеднике заповедники
методика: методики
широта: широт
группа: группу группе группа групп группы
хвостовой: хвостовой хвостовых хвостовые
конец: конце
яркий: ярко
неотропических: неотропических
похожий: похожие похожий похож похожим
ложноугрей: ложноугрей
широкий: широко
преувеличение: преувеличением
митохондриальным: митохондриальным
рука: руки
сказать: скажем
берлин: берлин
крошечный: крошечные
крепиться: крепится
редкий: редких редкого
икринки: икринки
выявлены: выявлены
вверху: вверху
процветающая: процветающая
циклоидная: циклоидная
уменьшаться: уменьшаются
искать: искал
откладывать: откладывает
добыча: добыча
мусаткиной: мусаткиной
неотропический: неотропический
карликовый: карликовым
явный: явно
вопрос: вопрос
вообще: вообще
семейство: семейства семейству семейств
газообмен: газообмена газообмен газообмене
постепенный: постепенно
засушливый: засушливый
грызущие: грызущие
восстановленный: восстановленный
достигающим: достигающим
различие: различия различиями
объект: объектом
выяснить: выяснить
межвидовые: межвидовые
агрессивный: агрессивный
нельсона: нельсона
исключение: исключением
конечность: конечностей
центральноамериканским: центральноамериканским
половозрелой: половозрелой
оказаться: оказался
ходить: ходят
фон: фоне
чешуя: чешуи чешуя
видимый: видимо видимому
метровый: метрового метровый
грунт: грунте
разработан: разработан
крайний: крайней
особь: особи особей
единичный: единичным
единственный: единственный единственной единственное единственном
камерун: камерун
статья: статьи статье
ил: ила иле
вместе: вместе
сливаться: сливаются
полоска: полоску
рассасывание: рассасывания
мегхалая: мегхалая
устроенный: устроен
китай: китая китае
средовой: средовой
англоязычный: англоязычной
микрокомпьютерной: микрокомпьютерной
неизвестный: неизвестно
генетический: генетическая генетическими
слой: слое слоя
дерево: деревьям
ложноугри: ложноугри
посттемпоральной: посттемпоральной
говорить: говорят
пережидать: пережидают
коста: коста
вполне: вполне
пошлый: пошло
провинция: провинция
кариотипа: кариотипа
показать: показал
неотропическими: неотропическими
происходить: происходит
склон: склоне
лимон: лимон
отношение: отношении отношения
протогинические: протогинические
дегенерировать: дегенерируют
способ: способы
таки: таки
рисунок: рисунок
принадлежать: принадлежит
нора: норы нору норах
полость: полости полость
изученные: изученные
рика: рика
камеруне: камеруне
рыба: рыб рыбы рыбах рыба
среди: среди
роющие: роющие
изучены: изучены
проникнуть: проник
пещерный: пещерный пещерных пещерными пещерного
внутренний: внутреннего
удивительный: удивительно
томографии: томографии
растительность: растительности
предстоять: предстоит
сходный: сходное сходно
входить: входят
пещера: пещер
полумесяц: полумесяца
обнаружить: обнаружила
сравнение: сравнению
достижение: достижении
строить: строят строит
обычный: обычный
галерея: галерею галереи
мексика: мексики
родственник: родственник родственниками родственником
строение: строения строением строение
строящие: строящие
страница: странице страниц
встречаться: встречается встречаются
следовать: следует
возможный: возможно
воображение: воображение
окраска: окраска
кровеносный: кровеносных
систематика: систематике систематики систематикой
игловидный: игловидная
родовой: родовое
остров: острова
период: период
комплекс: комплекс
род: рода род
меря: мере
длина: длиной длина длины
находиться: находились находится
вулкан: вулкана
сторонник: сторонника
том: томе
дыхание: дыхания дыхание
энергия: энергии
череп: черепом черепу
слабый: слабо
небольшой: небольших небольшой
справедливый: справедливо
страна: странах
пола: пола
механизм: механизмы
скорый: скорее
указывать: указывают
наличие: наличие
сеть: сетью
знаменитый: знаменитых
занятой: занятые
отметить: отметить
устойчивый: устойчивые
найден: найден
называть: называют
одно: одно
сомнение: сомнения
подводный: подводной
составлять: составляют составляет
членистоногих: членистоногих
атмосферный: атмосферным атмосферного
герой: героя
интернет: интернету
бассейн: бассейн
рудиментарный: рудиментарны
исчезать: исчезают
пометом: пометом
летучий: летучих
отмечаться: отмечалось
одна: одна
остаток: остатки
турист: туристов
таиланд: таиланде
общий: общей общие общее
ткань: ткани тканей
размер: размерах размеры размера размеров
днк: днк
хромосома: хромосом
плавник: плавники плавников
фото: фото
австралийский: австралийский австралийского
штат: штата
получать: получают
кодирующим: кодирующим
аппарат: аппарат
инвазивный: инвазивный
летающие: летающие
особенность: особенность особенности
расчистить: расчистить
проводить: проводят проводить
фауна: фауне
отличаться: отличаются
туловищного: туловищного
упоминать: упоминают
многочисленный: многочисленны
отдельный: отдельных
лес: лесу лес лесом
достаточный: достаточно
позвонок: позвонков позвонка позвонки
образ: образ
другой: другими
сородич: сородича
надклейтрум: надклейтрум
четырех: четырех
участок: участки
показаны: показаны
редактирование: редактирования
ухо: уши
орган: органом органов
солоноватый: солоноватых
развитой: развитой
рыть: роют
самый: самый самая
дышать: дышать дышат
покупать: покупают
филиппинах: филиппинах
предок: предками
находка: находка находкам
подпочвенный: подпочвенном подпочвенного
лишенных: лишенных
вход: входа
турриальба: турриальба
плечевого: плечевого
неотропического: неотропического
дальний: дальний дальним
жабры: жабр
болото: болота
помета: помет
восток: востока
быстрый: быстро
описанный: описанный описаны описан описанных описанными
пруд: пруды
влажный: влажной
пигментация: пигментации
используя: используя
разбираться: разбираться
использовать: использовали
ген: генам генов
предположительно: предположительно
задыхаться: задыхаются
зарастать: зарастают
карстовых: карстовых
велись: велись
слегка: слегка
вылупления: вылупления
гондванским: гондванским
ответ: ответ
родственный: родственных
линия: линии
рики: рики
коллега: коллегами
обратный: обратная
подтверждаться: подтверждается
дистанция: дистанция
данные: данные данным данными
осознать: осознаем
пар: паре
хищник: хищник
экстремально: экстремально
филогенетические: филогенетические
масса: массу
надежда: надежда
свет: свете
посвящено: посвящено
первый: первое первой первых
питаться: питается питаются питаться
цепь: цепи
превращаться: превращается
главный: главный
высокий: выше
второй: второе
дело: деле дело
довестись: довелось
кладка: кладку
позволить: позволило
флюта: флюта
очищенные: очищенные
рыбалка: рыбалку
желточного: желточного
передний: передних
восточный: восточном восточной
частный: частном частные
найденных: найденных
икра: икры икру икра
червеобразный: червеобразные
водоемов: водоемов
представитель: представитель
дождевой: дождевом
биосфера: биосфере
пора: поры
пригород: пригороде
мумбаи: мумбаи
зуб: зубов
характерный: характерных характерны
уровень: уровне уровня
примечательный: примечательно
тонкий: тонкое
живой: живой
яйцеклетки: яйцеклетки
знать: знаем
лужица: лужицах
наука: науке
развиваться: развивается
спинной: спинной
сторона: сторону сторона
главное: главного главные главное
ним: ним
банановый: банановой
интересный: интересная
половина: половины
обходиться: обходиться
илистый: илистые
отсутствие: отсутствие
кавычки: кавычки
затапливаемой: затапливаемой
кость: кость
карта: карта
глаз: глаза глаз
название: название
лас: лас
выкопать: выкопал
удаваться: удавалось
диаметр: диаметром
связывать: связывают
юкатана: юкатана
характеризовать: характеризуют
обитать: обитает обитать обитают
некоторые: некоторых некоторые некоторым
участвовать: участвуют
море: морей моря
ручей: ручьи ручья
грунтовых: грунтовых
век: века
анализ: анализу анализ
доходить: доходят
рике: рике
основный: основным основном основные
прекрасный: прекрасный
такой: таких
северо: северо
выборка: выборки
расширять: расширяют
собрать: собрали
рюкю: рюкю
вода: вод водой водах воды
стенка: стенкам
наджаберные: наджаберные
щель: щели
википедии: википедии
ласточка: ласточек
мягкий: мягких
объяснение: объяснение
сделана: сделана
целый: целой целом
змеевидный: змеевидное
заметка: заметки
трогломорфным: трогломорфным
отличие: отличий
работать: работают
образовать: образует образовали
ребер: ребер
сохраняться: сохраняется
пищевой: пищевой
первоописании: первоописании
удалось: удалось
икринок: икринок
показывать: показывают
монофилетическую: монофилетическую
джозефа: джозефа
исключительный: исключительно
поликультуры: поликультуры
независимый: независимое
редуцироваться: редуцируются
место: место
уменьшены: уменьшены
особый: особые
важный: важных
разлив: разливе
править: правило
хватиться: хватишься
глубина: глубины глубине глубину глубиной
водотоков: водотоков
редуцированный: редуцированные
самка: самкой самками самка
митохондриальных: митохондриальных
заболоченный: заболоченном
обитание: обитания
смещаться: смещаются
возле: возле
привлекая: привлекая
утрата: утрата
разрабатываться: разрабатываются
превращение: превращения
сильный: сильно
сайт: сайта
герпетолог: герпетолог
сделать: сделали
гавайях: гавайях
грудной: грудные грудных
воздух: воздуху воздухом
слитножаберниковые: слитножаберниковые
непарный: непарные непарное
помощь: помощью помощь
национальный: национальной
географического: географического
рынок: рынке
обитатель: обитателей обитатель
почвенный: почвенную почвенные почвенная почвенной почвенных почвенным почвенными
вовсе: вовсе
метр: метрах метра
диагностический: диагностические
вилочкообразной: вилочкообразной
вытянутый: вытянутое
флориду: флориду
выясниться: выяснилось
сходство: сходство
изогнутый: изогнутой
причем: причем
рисовый: рисовые рисовый
известный: известно известных
смена: сменой
рептилия: рептилии
ложноугорь: ложноугорь
водный: водные
обратить: обратим
пузырёк: пузырьков
статус: статус
разный: разных разным
экзотичный: экзотичны
бобровый: бобровые
взрослый: взрослый
мелкий: мелкий мелкая мелких мелкие
частить: части
наружный: наружные
змея: змеями змей
рыбка: рыбки рыбок
указано: указано
неотропические: неотропические
анальный: анальный
хвостик: хвостик
земля: земли
описываться: описываются
подземный: подземных
скрытый: скрыты скрытые
например: например
эрик: эрик
сосуд: сосудов
чебурашки: чебурашки
почва: почве почвы почву
обнаружение: обнаружения
гораздо: гораздо
мышей: мышей
близость: близости
вынашивать: вынашивает
управление: управления
