тяжелый: тяжелый
боль: боль
изученных: изученных
точка: точки
рыба: рыб рыбы рыбой рыбе рыба рыбу рыбам
горизонтальный: горизонтальные
порядковый: порядков
показать: показал
загрязнителей: загрязнителей
завод: завод
твердые: твердые
основание: основании основанием
водоемах: водоемах
второй: вторых
данные: данные
бескислородные: бескислородные
определена: определена
атмосфера: атмосфере
конечный: конечном
план: план
пресноводный: пресноводных
количество: количество
немалый: немало
век: века
сайт: сайта
озерах: озерах
миграция: миграцию
увеличение: увеличению увеличение
инвазивный: инвазивный
обозначены: обозначены
трофический: трофический
близкий: ближе
состояние: состоянию состояние
действие: действие действием
итай: итай
впервые: впервые
метилирования: метилирования
часть: часть частей
стандартный: стандартным
достаточный: достаточной
пороговый: пороговое
задерживаться: задерживается
условие: условий условия
больной: больно
создавать: создавать
согласный: согласно
увеличивая: увеличивая
степень: степени
ареал: ареал
прояснить: прояснить
побережье: побережья
обратить: обратили
толчок: толчком
заселенных: заселенных
воздух: воздухе
изменение: изменений
казаться: казалось
повторности: повторности
звено: звеньев
потребление: потребления
частность: частности
число: числе число
функция: функций
поскольку: поскольку
отметить: отметить
измерение: измерений
анаэробных: анаэробных
образ: образом
стабильный: стабильных
увеличена: увеличена
проблема: проблемой проблемы
выйти: вышли
вылавливать: вылавливали
изучались: изучались
бассейн: бассейна бассейном
годов: годов
кружочек: кружочки
очищать: очищает
признавать: признают
токсин: токсин
элементорганического: элементорганического
пелагической: пелагической
обитатель: обитателях
биодоступность: биодоступность
соседство: соседству
наблюдаемой: наблюдаемой
накопление: накопления накоплением накопление
вызванный: вызванные
пошлый: пошла
трофические: трофические
получить: получить
точный: точно
больший: большей
конец: конце концу
площадь: площадь
толстый: толстые толще
ресурс: ресурсов
показаны: показаны
свободный: свободные
совместный: совместное
фитофагов: фитофагов
существенный: существенных
вода: водах воды воде воду
различный: различных различной
инвазии: инвазии
комплексный: комплексный
справедливость: справедливость
обозначать: обозначают
герой: герои
нарушение: нарушениями
центральный: центральной
привести: привести
расти: растут
дальнейший: дальнейшие
тяжелыми: тяжелыми
исследователь: исследователи
ранее: ранее
накопить: накопить
михаил: михаил
связь: связи связью
дальний: далее
префектура: префектуры
разобраться: разобраться
вывод: выводы
окунь: окунь окуня
выделиться: выделилась
регион: регионов
открытый: открытой
эффект: эффект
нижний: нижний
высокий: выше высоким высоких
поллютантов: поллютантов
перенос: переносе перенос
двустворчатый: двустворчатого
литорали: литорали
фильтратор: фильтратор
измерить: измерили
область: области
прочий: прочих
усреднены: усреднены
характер: характеру характера
десятилетие: десятилетий
понимание: понимание
ограничение: ограничения
длительный: длительный
наблюдаемые: наблюдаемые
деятельность: деятельности
производство: производству
подобный: подобных
функционирование: функционирования
морфометрические: морфометрические
интерпретация: интерпретации
инвазивным: инвазивным
токсикологии: токсикологии
миннесота: миннесота
рачков: рачков
извне: извне
среда: среды сред среду
переходить: переходила переходит
сантиметр: сантиметров
меря: мере
азот: азота
сверху: сверху
угрожать: угрожать
человек: человека человеку людей
объединить: объединила
афоризм: афоризмов
учесть: учесть
пелагический: пелагический
содержать: содержали содержала
изотопный: изотопный
популярный: популярные
ископаемое: ископаемых
середина: середине
инвазивного: инвазивного
полупрозрачный: полупрозрачными
направо: направо
светлоперый: светлоперый
пример: примере пример
поденок: поденок
собраны: собраны
длина: длины
зависимость: зависимости
сложность: сложность
рамка: рамках
значимый: значимых значимо
поблизости: поблизости
убыль: убыль
кишечник: кишечника
вред: вред
японский: японского японской
частица: частицы
ртуть: ртутью ртути ртуть
экологический: экологические экологических
первый: первого первых
животное: животное животных
момент: момент моменты
значение: значения значение
уделять: уделяют
быстрый: быстрых
объесть: объем
оранжевый: оранжевым
увеличиться: увеличиться
гормональный: гормональную
обратный: обратной
переход: перехода переход
рост: роста росту рост
фитопланктоном: фитопланктоном
пища: пищей
окружающий: окружающей
прямой: прямое прямых
кейс: кейсами
минимальный: минимальный
репродуктивный: репродуктивного
нервный: нервной
непростой: непросто
включая: включая
служить: служит
требоваться: требуется
корректный: корректного
спинной: спинной
средний: среднем средняя средней среднее
миннесоте: миннесоте
красный: красным
скелет: скелета
причина: причиной
другой: другими
определенное: определенное
начало: началу
заниматься: занимается
начиная: начиная
америка: америки
предел: пределах
водоем: водоем
рис: рис
пищевой: пищевых пищевой пищевые
коммонера: коммонера
размер: размер размера
хвост: хвоста
пунктирный: пунктирные
фото: фото
ткань: тканях
органический: органическую органические органического органическая органической
переключение: переключением
трагедия: трагедии
синергию: синергию
веслоногих: веслоногих
статья: статьи статья
россия: россии
полоса: полосами
тяжелых: тяжелых
кадмий: кадмием
кормиться: кормится
общий: общей
вылов: вылову
озер: озер
токсичный: токсичны
каждый: каждого каждой
оказывать: оказывают
метр: метра метров
положение: положение
бокоплавы: бокоплавы
обсуждаемой: обсуждаемой
бактерия: бактерий
окраска: окраски
сопредельный: сопредельных
агрессивный: агрессивным
канада: канаде
свет: света
природный: природных природную
особый: особое
специфический: специфический
мышца: мышцы
тело: тела
рассчитанный: рассчитаны
житель: жителей жители
попадание: попаданием попадании
сильный: сильную сильно
отличие: отличий
взрослый: взрослых взрослый взрослые
особь: особей особи
экология: экологии
связать: связали
включающий: включающий
светлоперого: светлоперого
чувство: чувств
накапливаться: накапливалась
развиваться: развиваются
регуляция: регуляцию
дрейссеной: дрейссеной
добыча: добычи
эпизод: эпизодов
категория: категории
верхний: верхний
перестройка: перестройкой перестройкам
неорганический: неорганические неорганическая
донный: донных
варьировать: варьирует
метилртуть: метилртуть
доверительный: доверительные
департамент: департаментом
успевать: успевают
разный: разных разные
вселенцев: вселенцев
последствие: последствиям последствий
химический: химических химический химическому
жертва: жертв жертва
озерами: озерами
женщина: женщины
означать: означает
литоральный: литоральные литоральной
воздействие: воздействие
анализ: анализа анализу анализ
считать: считали
промысловый: промыслово
форма: форму формой форме форма
предполагаемый: предполагаемое
изображение: изображение
возможность: возможности
объяснять: объясняют объясняет
механизм: механизму
снижаться: снижается
среди: среди
чужеродный: чужеродного
нашествия: нашествия
личинка: личинки
суть: сути
несмотря: несмотря
взвесь: взвеси
размножение: размножение
выяснить: выяснили
заметный: заметно
барри: барри
зоопланктон: зоопланктон зоопланктоном
показывать: показывает
объект: объекты
опасный: опасную
внимание: внимание
биомасса: биомассы
похожий: похожими
эффективный: эффективный
самый: самым
прибрежный: прибрежных прибрежную
оказаться: оказался оказалось оказались
микроорганизм: микроорганизмов
метилирование: метилирование
главное: главным
влажный: влажного
цепь: цепях цепей цепи
экотоксикологии: экотоксикологии
ряд: ряд
снижение: снижение
обитать: обитало обитает
расширить: расширило
северный: северной
заселены: заселены
описать: описали
обе: обе
обеих: обеих
называть: называют
данный: данный
выбирать: выбирали
важный: важно
япония: японии
проявляться: проявляется
антропогенного: антропогенного
пар: пара
изотоп: изотопов
исследование: исследования исследовании исследование
водосборного: водосборного
углерод: углерода
оценить: оценили
подвергшиеся: подвергшиеся
выборка: выборке
видимый: видимому
характеристика: характеристики характеристиками
затронутыми: затронутыми
ребёнок: дети
слева: слева
питаться: питались питается питаются
влияние: влияние
справа: справа
вызвать: вызвал
необходимый: необходимо
перемещение: перемещения
прозрачность: прозрачность
частить: части
удаленных: удаленных
следствие: следствие
заболевание: заболевания
страна: стран
равный: равным равных равна
получать: получает
автор: авторы
штат: штате штата
подвергнуться: подверглись
мелкий: мельче мелких
роль: роль
массовый: массовым
ранний: раннем
некоторые: некоторыми
речной: речная речной
минамата: минамата
редкий: реже
возможный: возможно возможной возможную возможным
сша: сша
возрастной: возрастные
интоксикация: интоксикацией
гораздо: гораздо
мешать: мешает
исключить: исключить
миллион: миллион
экотоксикологическим: экотоксикологическим
вид: видов вида видом вид
протокол: протоколам
загрязнение: загрязнения загрязнение
описанный: описанной
глобальный: глобальном
живой: живых
фон: фоне
система: системы
дрейссены: дрейссены
массы: масс
проанализированы: проанализированы
интервал: интервалы
детальный: детальное
различаться: различаются
соотношение: соотношения
источник: источникам источники источник
вроде: вроде
продуцентами: продуцентами
крупный: крупных крупнее
вес: веса
поражающий: поражающие
факторов: факторов
ускоренный: ускоренного ускоренной
менять: меняет
сказаться: скажется
орган: органов
представлять: представляют
здравоохранение: здравоохранения
связано: связано
усы: усы
приводить: приводят
одноименного: одноименного
сбрасывать: сбрасывал
инвазией: инвазией
максимальный: максимально максимальный
экосистема: экосистем экосистемах
вплоть: вплоть
биологический: биологические биологическую
предсказать: предсказать
повышенный: повышенной повышенным
организм: организмов организм организме
классический: классическими
страдать: страдали страдают
метилртути: метилртути
английски: английски
изучена: изучена
соответственный: соответственно
судак: судак судака судаки
концентрация: концентрация концентрации концентрацию
негативный: негативное негативных
состав: составе состав
попадая: попадая
помощь: помощью
медианные: медианные
должный: должны должен
залив: залива
американский: американские
развитие: развитию
соединение: соединения
удобрение: удобрений
закон: законов
крайний: крайней
неожиданный: неожиданный
неучтенных: неучтенных
болезнь: болезнью болезни болезнь
таковой: таковы
полезный: полезных
хищник: хищникам хищник хищники
влиять: влияют влиять
привлечь: привлечь
связанный: связанный связанная
цепочка: цепочке
проба: пробы
биоаккумуляции: биоаккумуляции
хронический: хронической
повреждение: повреждения
земля: земли
зона: зоны зону зоне
сеголеток: сеголеток
незаселенных: незаселенных
снижать: снижает
группа: группы группе групп группами
решить: решили
зебра: зебра
существах: существах
берег: берегов берега
ограниченный: ограниченные
пять: пяти
исходный: исходно
консументов: консументов
ускорение: ускорением
такой: таких
сторона: стороне стороны
тщательный: тщательный
металл: металл металлов металлами металлу металла
случай: случаи случае
патология: патологией
например: например
территория: территории
тонкий: тонкие
здоровье: здоровья здоровью
отдельный: отдельных отдельно отдельные
опубликована: опубликована
иметь: имеет имеют
проводиться: проводилось
доля: долю доля
поедать: поедает
суммарный: суммарное суммарной
согласоваться: согласуются
озеро: озера озере озеро
экотоксикология: экотоксикология
продукция: продукцию продукции
замедление: замедление замедлением
экземпляр: экземпляры
моллюск: моллюском моллюска моллюск моллюски
использовать: использует использовали
работа: работы
растворенного: растворенного
вспоминать: вспоминают
характерный: характерной
признак: признаков признаках
линия: линии линиями
голова: головы
паралич: паралича
итог: итоге
явление: явления
водоемов: водоемов
водоемы: водоемы
растет: растет
прочее: прочего
уровень: уровень уровни уровне уровня
полосатый: полосатой
великий: великие
заселенные: заселенные
орёл: орлов
желтого: желтого
разнообразный: разнообразно
подтвердив: подтвердив
глубина: глубиной глубины
ветвистоусых: ветвистоусых
модельный: модельные
рыбалка: рыбалки
содержание: содержанием содержание
живет: живет
дополнительный: дополнительно
целый: целом
разрушение: разрушение
доступный: доступных
прежде: прежде
вещество: вещества
многие: многие
голубой: голубым
переключаться: переключались
трофического: трофического
снизу: снизу
тояма: тояма
беспозвоночный: беспозвоночные беспозвоночных
брюхоногие: брюхоногие
возраст: возрасте возраста
оценка: оценки
отмечена: отмечена
показано: показано
благоприятный: благоприятных
разуметься: разумеется
сустав: суставов
движение: движений
речь: речь
официальный: официальных
желтый: желтый
цвет: цветом
распространение: распространения
связывать: связывают
питание: питание питании
вселение: вселение
живущий: живущие живущих
новый: новой новые
подход: подходы подход
энергия: энергии
дно: дне
порядок: порядка
консументы: консументы
масштаб: масштабе
микроб: микробами
четырех: четырех
ускоряющих: ускоряющих
ускорять: ускоряет
перевод: переводе
отмеченная: отмеченная
море: море
отложение: отложениях
литораль: литораль
отделять: отделяли
спектрометр: спектрометре
озерную: озерную
стать: стали стало
журнал: журнале
название: названием
сравнение: сравнения сравнению
результат: результате результат
морепродукт: морепродуктами
известный: известно известным известной
период: период
дрейссена: дрейссена
гектар: гектар
сеголетки: сеголетки
способствовать: способствовать
рекомендация: рекомендациях
прежнему: прежнему
который: которое которому
вызывать: вызывает вызывают
возникнуть: возникли
психоз: психоза
смерть: смерти
водосборным: водосборным
