ученых: ученых
функция: функций
перегнать: перегнать
известный: известен
польза: пользы
посмотреть: посмотрите
самый: самым
открытие: открытия
аппарат: аппаратом
условие: условия
находящимся: находящимся
проблема: проблемой
ученые: ученые
прототип: прототипов
хрупкость: хрупкость
воспользоваться: воспользовались
компьютер: компьютер
одним: одним
оцифровывался: оцифровывался
передача: передачи
надеяться: надеются
игрушечный: игрушечную
превращаться: превращались превращаются
поразительный: поразительных
скорость: скорости
данные: данные
неинвазивной: неинвазивной
базальную: базальную
машинка: машинку
импульс: импульсов импульсы импульса
классический: классические
быстрый: быстро быстрее
максимальный: максимально
ремарка: ремарка
примитивный: примитивной
увидеть: увидим
точка: точки
вёшенка: вёшенка
двигательный: двигательным
ультрафиолетом: ультрафиолетом
ионный: ионных
накапливаться: накапливаются
принтер: принтере
скелетных: скелетных
представляющего: представляющего
техник: техники
банальный: банальных
ловкость: ловкости
отвечать: отвечать
скорый: скоро скорее
червь: червей
мягкий: мягкий
труд: трудом
понимание: понимании
физиологические: физиологические
оказаться: оказался
ускоряя: ускоряя
дискретизации: дискретизации
соединить: соединить
шагать: шагать
поживем: поживем
эндрю: эндрю
адамацки: адамацки
шагающего: шагающего
используются: используются
грибной: грибного
освоение: освоении
частить: части
создан: создан
вариант: вариант
передавая: передавая
план: плане
заключение: заключении
приблизив: приблизив
нейрон: нейронов
чашка: чашке чашки
повлиять: повлияло
нечто: нечто
свет: свет светом света
научить: научили
мышечный: мышечную
внеклеточно: внеклеточно
достаточный: достаточно
являться: является
изготовление: изготовлении
управляющим: управляющим
выполняющих: выполняющих
создание: создание
активность: активности активность
найти: найти
паук: пауком
нога: ногами
съедобный: съедобный
вспышка: вспышки
робототехников: робототехников
открывающие: открывающие
ткань: ткани ткань
обучение: обучению
обсуждаемой: обсуждаемой
время: временем
яркий: ярко
тема: тема
бум: бум
соединение: соединения
активировать: активировало
система: системам
ультрафиолета: ультрафиолета
управляемый: управляемым управляемый
считывающими: считывающими
слово: слов
видимый: видимым
просматривается: просматривается
параметр: параметров
мышца: мышцы мышц
составляющая: составляющей
основа: основой основе
изучить: изучили
раздражитель: раздражителей
прецизионный: прецизионные
организация: организацию
вопрос: вопросу
механизм: механизм
сборка: сборки
например: например
вдоль: вдоль
разряжаться: разряжаться разряжался
страница: страницы страницу
уходя: уходя
первый: первых первым
фраза: фраз
достижение: достижение
необходимый: необходимо
представляться: представляется
средний: среднее
сложный: сложную
резвый: резво
биомеханизм: биомеханизм
простой: простые простого
недостаток: недостаток
обнаружить: обнаружил
петри: петри
позволять: позволяют
погрузчик: погрузчиков
опорный: опорно
британский: британский
разность: разности
последний: последнее
научный: научный научной
сигнал: сигнал
европа: европы
высота: высот высоты
тип: тип
распространенного: распространенного
сила: силы
мощнее: мощнее
последовательность: последовательности
скачок: скачок
мембрана: мембраны
практический: практический
писать: писали
группа: группа
вытворять: вытворять
невольный: невольно
университет: университета
двигаться: двигались
облучение: облучение
современный: современных
заставлять: заставлял
прикладной: прикладном
животное: животных
видео: видео
конвертируясь: конвертируясь
подумать: подумаешь
шевелить: шевелил
фундаментальный: фундаментальная
шагающий: шагающий
повреждая: повреждая
результат: результате результаты
устройство: устройство
морской: морской
новый: новую
решающий: решающего
зрение: зрением зрения
точнее: точнее
зависеть: зависел
подкаста: подкаста
реакция: реакция
семейство: семейства
разумный: разумный
распространяться: распространяется
называть: называют называть
ослабевать: ослабевала
электронный: электронным
полученные: полученные
биороботы: биороботы
нейросети: нейросети
сайт: сайта сайте
генерировать: генерировать генерирует
удаленно: удаленно
установленный: установленной
итог: итоге
искусственный: искусственные искусственно
нервный: нервные нервного
выносливый: выносливый
биологический: биологические биологическим биологического биологической
своеобразный: своеобразный
собственный: собственная
прыгать: прыгать
биороботах: биороботах
фото: фото
качество: качестве
устойчивый: устойчивый
лес: лесах
действие: действия
белка: белок
выращенных: выращенных
слизевика: слизевика
получившиеся: получившиеся
располагаться: располагались
ехать: ехать
отрицательный: отрицательный отрицательным
гипотеза: гипотезами
длина: длине
этап: этапе
человек: людей человека
медуза: медуз
регистрация: регистрации
единица: единиц единицы
операция: операции
кадр: кадр
похожий: похоже
отмечать: отмечаю
вешенки: вешенки
мицелий: мицелий мицелия
хирургический: хирургические
отмирать: отмирают
развитие: развития
разный: разные
точный: точно
дело: делом
вёшенку: вёшенку
существенный: существенный
электрод: электроды электродами электродов
синить: синим
обескураживающими: обескураживающими
изменение: изменения
приговор: приговор
покой: покое
мозг: мозгом мозг мозга
исследование: исследования исследований
такой: такими такую таким
нынешний: нынешнем
фоторецепции: фоторецепции
биология: биологии
применение: применение
движение: движениями движение движения
компания: компании
переживать: переживают
сомнение: сомнений
чувствительный: чувствителен
удалось: удалось
решить: решили
кратковременный: кратковременный
канал: каналов
ранее: ранее
наличие: наличие наличии
преобразовываться: преобразовывался
тело: тела
генерация: генерации
перспектива: перспективе
парализованных: парализованных
наделяя: наделяя
практически: практически
выбор: выбор
сомнительный: сомнительным
фантастов: фантастов
автор: авторы
фототаксисом: фототаксисом
электрофизиологии: электрофизиологии
пар: пару
разработка: разработки разработок
группироваться: группируются
ультрафиолетовое: ультрафиолетовое
конвейерный: конвейерных
писатель: писателей
организм: организм организме
попробовать: попробовать
предыдущий: предыдущих
вверху: вверху
способный: способен способны
способность: способностями способность способности
переменный: переменным
звезда: звездой
показаться: показаться
имитирующие: имитирующие
обе: обе
волна: волны
распространенный: распространенный
движущий: движущей
управлять: управлять управляла
волновать: волнует
статья: статью статье статьи
примерно: примерно
задействовать: задействовать
второй: вторых втором
живой: живым живые
моллюск: моллюсков
попытаться: попытаться
способ: способ
степной: степной степная
вспомнить: вспомнить вспомним
растущего: растущего
источник: источника источник
плавать: плавать
смочь: смогла смогут
музыка: музыки
получить: получить
крайний: крайне
напоминающего: напоминающего
мочь: могли
успех: успехом
идет: идет
звуковой: звуковые
георгий: георгий
плодовый: плодовые
реагировать: реагировать реагировали реагирует
маска: маска
среда: среды
сконструировать: сконструировали
установить: установили
оцифровке: оцифровке
грибороботы: грибороботы
потенциал: потенциал потенциалом потенциалов потенциалы
либо: либо
значимость: значимость
марс: марса
вёшенки: вёшенки
убегать: убегать
потенциальный: потенциально
реабилитация: реабилитации
заставляя: заставляя
клеточный: клеточной
нуль: нулей нули
визуализировать: визуализировать
полученный: полученный
посредство: посредством
сочетаться: сочетаются
ультрафиолетовым: ультрафиолетовым
выяснить: выяснили
очевидный: очевидных
колёсико: колесиками
линия: линиях
биогибридных: биогибридных
вплоть: вплоть
сторона: стороны
нейрокомпьютерный: нейрокомпьютерный
развить: развить
нашем: нашем
использовать: использовать использовали
примитив: примитив
целиком: целиком
предположить: предположил
пик: пиков
исследователь: исследователей исследователь исследователи
окружающий: окружающей
родительский: родительский
множество: множество
активный: активнее
клетка: клетки
колебание: колебания
крутило: крутил
напечатанных: напечатанных
стоять: стоит
компонент: компоненты
фототаксис: фототаксис
излучение: излучение излучения излучением
протез: протезов
художественный: художественное
корнеллского: корнеллского
работа: работы
микокомпьютерный: микокомпьютерный
ползать: ползать
интересный: интересным интересные
счет: счет
биоробот: биоробот
человеческий: человеческих
несмотря: несмотря
воплощение: воплощение
задача: задачи
сокращение: сокращения
позволяющих: позволяющих
десятилетие: десятилетия
биороботов: биороботов
подобие: подобие
осторожный: осторожным
основный: основных
биоробота: биоробота
электроника: электроникой электроники
сенсор: сенсор
куракин: куракин
существам: существам
стимулировать: стимулировало
заставить: заставить
достигнуть: достигли
выполнять: выполнять
илона: илона
речь: речь
пример: примеров
гибкий: гибко
подойти: подойти
явление: явление
робот: роботом роботов роботы робота робот
контроллер: контроллером
селективности: селективности
фоторецептов: фоторецептов
электрический: электрических электрические электрической электрическую электрическая
механический: механические механическим
свой: свой
подобрать: подобрать
какой: каких
полноценный: полноценного
присущий: присущее
уносить: уносить
адаптация: адаптации
отсутствие: отсутствии
смысл: смысл
технический: техническое
рис: рис
сочетание: сочетания
средство: средств
гриб: гриба гриб грибов грибом
элемент: элементов элементы
язык: язык языка
стать: стало
помощь: помощью
убегающих: убегающих
образ: образом
частота: частоты
гораздо: гораздо
показатель: показателям
интерфейс: интерфейс интерфейса
иметь: имеет
