денисовцами: денисовцами
протяжение: протяжении
кошачьи: кошачьих
получить: получил
полутора: полутора
похожий: похожий похоже
тропик: тропиков
стратиграфию: стратиграфию
благородный: благородный
олень: олень
орёл: орла
господствующий: господствующим
кружочек: кружочки
международный: международный
древние: древние древними
нгу: нгу
определен: определен
обнаружено: обнаружено
археологический: археологические археологических
изготавливать: изготавливали
наверняка: наверняка
морфологически: морфологически
сапиенсы: сапиенсы
зверь: зверей
найти: нашли
заяц: зайцы
высокий: высокая
либо: либо
детальный: детальную
попытаться: попытались
окрестность: окрестностях
возможный: возможно
использовался: использовался
никакой: никаких
оказаться: оказаться оказалась
анализ: анализ анализа
морфология: морфологии
правдоподобный: правдоподобной
денисовскому: денисовскому
пунктир: пунктиром
наоборот: наоборот
вид: видов видом виде
общий: общей
лошадиный: лошадиный
предгорье: предгорий
оставаться: оставалась оставалось
уточнены: уточнены
доказательство: доказательство
денисовцев: денисовцев
судя: судя
сурок: сурки сурка сурков
коллагены: коллагены
пещерный: пещерного пещерных
изменение: изменение изменениями изменений
хищник: хищников хищники
крыло: крыльев
присутствовать: присутствуют
гоминины: гоминины
регион: регионов
лаос: лаоса
остаток: остаткам
бык: быков
благоприятный: благоприятные
теплого: теплого
неплохой: неплохо
элемент: элементы
популяция: популяций
молодой: молодом моложе молодых
средне: средне
найдены: найдены
дополнительный: дополнительных
единственный: единственной
представитель: представители
накопление: накопления
кость: костях кость
раскалывать: раскалывали
находка: находками находок
присутствие: присутствие присутствия присутствию
уникальный: уникальные
найденных: найденных
произойти: произошло
постепенный: постепенно
коллагена: коллагена
придать: придать
восточноазиатские: восточноазиатские
архаичный: архаичные
район: районе
сапиенсов: сапиенсов
денисовских: денисовских
моляр: моляр
доложить: доложил
грунт: грунта
широкий: широко
ясный: ясно
фазан: фазанов
ранее: ранее
оледенение: оледенения оледенение оледенением
примитивный: примитивные
восточный: восточной
следующий: следующий
доля: доля
первый: первое
климатический: климатических климатическим климатическая
результат: результатах результате результатами результатам
мясо: мясо
перепел: перепелов
одна: одна
жить: жили
скорый: скорее
удаление: удаление
распределение: распределение
зеленые: зеленые
признак: признаков признаки признаками
встречаться: встречаются
неравнодушный: неравнодушны
разный: разными разных
днк: днк
среднепалеолитическими: среднепалеолитическими
кабарга: кабарга
меняться: менялся менялись
флора: флора
обнаружена: обнаружена
интерес: интерес
денисовская: денисовская
зацикливались: зацикливались
денисовской: денисовской
неандертальцы: неандертальцы
крупный: крупную крупных
распространены: распространены
повадка: повадок
использовать: использовали
молекула: молекул
орлиный: орлиным орлиных
стабильный: стабильным
облик: облик
статья: статьи статья статье
фото: фото
пещера: пещере пещера пещеры
возраст: возрастом возраст
нести: несут
тушить: туши
смениться: смениться
принадлежать: принадлежала принадлежало
работа: работы
подсемейство: подсемейства
свидетельствовать: свидетельствует
современный: современных
баран: баранов
снижаться: снижается
последовательность: последовательности
археолог: археологов археологи
погрызы: погрызы
оставлять: оставляют
идея: идеей
генофондах: генофондах
мозг: мозга мозг
использовавшийся: использовавшийся
показывать: показывают
добывать: добывали
добавиться: добавился
датировка: датировки
продолжаться: продолжаются
технологический: технологическом
помочь: помогло
зуб: зубов зуб
сапиенсами: сапиенсами
лесной: лесные
носорог: носороги носорогов
проба: пробы
период: периода
вымереть: вымерли
причем: причем
примерно: примерно
голубой: голубых
идентифицируются: идентифицируются
жизнестойкость: жизнестойкость
указывать: указывали
моляры: моляры
опубликованная: опубликованная
ландшафт: ландшафты
разделяющее: разделяющее
журнал: журнале
поскольку: поскольку
данные: данные
фауна: фауне фауны фауна
охотничий: охотничьих
шестисантиметровый: шестисантиметровый
задуматься: задуматься
сотня: сотен
проанализировать: проанализировали
среднепалеолитические: среднепалеолитические
какой: каком
метода: методами
лошадь: лошадей
пытаться: пытались
столь: столь
конкурентный: конкурентном
среда: среды
человеческий: человеческих человеческие человеческой
последний: последнего
связано: связано
основный: основным основном основные основное
начало: начале
позвонок: позвонок
версия: версия
север: севере
грубый: грубых
жвачный: жвачного
обитать: обитали
окружающий: окружающей
изучение: изучении
поэтому: поэтому
позволить: позволили
охотиться: охотились
ученые: ученые
интересоваться: интересовались
увеличенные: увеличенные
понятный: понятно
местный: местной
фактором: фактором
денисова: денисова
изготовлены: изготовлены
сообщить: сообщили
добыча: добычи добычу
денисовой: денисовой
июль: июля
сохраниться: сохранились
заставлять: заставляет
красный: красные
приход: прихода
стать: стало
лёгкий: легко
исключение: исключения
метилированию: метилированию
позднеплейстоценовых: позднеплейстоценовых
указывающими: указывающими
выглядеть: выглядит
орудие: орудиями орудия орудий
сразу: сразу
денисовцу: денисовцу
денисовцы: денисовцы
мелкий: мелкую мелких
таксономическую: таксономическую
неопределимый: неопределимых
слабый: слабой
охватывать: охватывает
вплоть: вплоть
палеопротеомного: палеопротеомного
митохондриальной: митохондриальной
тибетский: тибетского тибетские тибетских тибетском
доказанный: доказано
получено: получено
определить: определить
факт: факт
аминокислотный: аминокислотные
костяной: костяных костяные костяное
сомнение: сомнений
межледниковьем: межледниковьем
приспособяемость: приспособяемость
генетический: генетических генетические
байшья: байшья
косвенный: косвенные
ребро: ребра ребро
сохранившимся: сохранившимся
костный: костных костного костный
сова: совы
который: которому котором
приведены: приведены
высота: высоте
отметина: отметинами
случай: случае
показать: показал
растительноядных: растительноядных
вымирание: вымирания
разбивать: разбивали
палеопротеомный: палеопротеомный
разработать: разработали
морфологический: морфологического
атлас: атлас
живой: живых
костя: кости костей
ареал: ареал
объединённый: объединены
участок: участки
предпоследний: предпоследнее
отделять: отделяли
материал: материалах
древнейший: древнейшими
долгий: долгого
снятие: снятия
ретуширование: ретуширования
снимать: снимали
видимый: видимому
сказано: сказано
марков: марков
денисовца: денисовца
инструмент: инструменты
обнаружены: обнаружены
практик: практик
александр: александр
местонахождение: местонахождения местонахождениям
слой: слоя слоях слое слою
сложность: сложности
шерстистый: шерстистые шерстистых
рис: рис
удалось: удалось
мастерить: мастерили
вытеснение: вытеснении вытеснение
косточка: косточек
оставить: оставили
масштабный: масштабных
протянуться: протянулся
успеть: успело
сравнение: сравнению
неясный: неясной
прямой: прямое
травоядный: травоядных
прохладный: прохладных
найден: найден
принадлежавший: принадлежавший
плечевой: плечевой
популяцияй: популяцияй
указание: указания
систематический: систематически
вероятный: вероятно
денисовского: денисовского
одном: одном
помимо: помимо
удар: ударов
жаркий: жарких
человек: человека человеку людей
видный: видно
растет: растет
родич: родичи
форма: форму
зона: зонам
птичий: птичьими
изделие: изделия изделие
плато: плато
азия: азии
алтай: алтае алтая
предел: пределами
пещерье: пещерье
составлять: составлять
подробный: подробные
время: временем
след: следы следов следами
отрезок: отрезков
гораздо: гораздо
найденная: найденная
знаменовать: знаменует
козлиный: козлиных
каменный: каменными каменные каменных
отложение: отложений отложениях
такой: таких
некоторый: некоторое
слоев: слоев
хозяйственный: хозяйственных
число: числе
срезать: срезали
длина: длина
точка: точкой точки
таксономическое: таксономическое
треугольничками: треугольничками
каждый: каждым
значительный: значительно
подтверждать: подтверждают
этап: этап
рука: рукой
согласоваться: согласуется согласуются
поздний: позднего позднем
рисунок: рисунок
способ: способами
интервал: интервал
восток: востоке
целый: целом
травяные: травяные
некоторые: некоторые некоторых
грызун: грызунов грызуны
плечевая: плечевая
увеличенный: увеличенный
установленный: установлена
новый: новые новая новым новой
известный: известный
хронология: хронология
чей: чью
преобладать: преобладают преобладали
дзеренов: дзеренов
гиена: гиены гиен
отмеченный: отмеченный
евразия: евразии
обломки: обломок
образец: образцов образец
обработка: обработки
тысячелетие: тысячелетий
причина: причинах
средний: среднего среднем средних
челюсть: челюсть челюсти челюстью
перо: перьям перьями перьев перья
трех: трех
показан: показан
тибет: тибете тибет
коллагенов: коллагенов
северо: северо
индокитая: индокитая
мозговые: мозговые
прогресс: прогрессе
доступный: доступную
высокогорья: высокогорья
гвинее: гвинее
карстовой: карстовой
обнаружение: обнаружении
добраться: добраться
псовый: псовых
изображение: изображением изображении изображения изображение
воссоздать: воссоздать
шкура: шкуры шкур
течение: течение
исследователь: исследователи
птица: птиц
быстрый: быстрым
обсуждаемой: обсуждаемой
принадлежность: принадлежность принадлежности
денисовцам: денисовцам
желтые: желтые
коллектив: коллектив
наряд: наряду
нагорье: нагорья нагорье
палеопротеомными: палеопротеомными
минимум: минимум
проявлять: проявляли
перемена: переменам
обнаружить: обнаружить
источник: источник
плейстоцен: плейстоцена плейстоцене
разнообразие: разнообразие
межледниковье: межледниковье
название: название
климат: климат
раскопки: раскопок
видовой: видовой
плейстоценовых: плейстоценовых
выборка: выборке
открытый: открытые
отмечены: отмечены
разнообразный: разнообразную разнообразным
дичь: дичь
сяхэ: сяхэ
хао: хао
як: яков
разделывать: разделывали
исчезать: исчезают
исцарапанный: исцарапанный
фрагмент: фрагментам фрагментов фрагмент
адаптироваться: адаптировались адаптироваться
примесей: примесей
окончательный: окончательно
разделка: разделки
копытный: копытных
