отложение: отложениях
лягушка: лягушки лягушек
вести: ведут
жизнь: жизни
середина: середине
эволюционный: эволюционная эволюционной
минимум: минимум
эффективный: эффективным
маймонида: маймонида
микроскоп: микроскопом
смочь: смогла смогло
окружающий: окружающей окружающим
оценить: оценили
крупнейший: крупнейшие
жизненный: жизненный
возможный: возможно
делать: делает
совершенный: совершенно
жабры: жабры жабр
аргентина: аргентины
вообще: вообще
развитие: развития
весьма: весьма
существо: существо
например: например
расти: расти
интерес: интерес
ученые: ученые
сантиметр: сантиметров
скелет: скелету
вид: вида видов виды вид виду
срастись: срослись
живший: живший
прибыль: прибыли
сразу: сразу
головастик: головастика головастик головастики головастиков
хвост: хвостами
крус: крус
великан: великан
частность: частности
исследователь: исследователи исследователей
триасе: триасе
нерв: нервов нервы
исключительный: исключительно
питающийся: питающийся
настоящий: настоящим настоящие
контур: контура
буэнос: буэнос
мерка: меркам
мелкий: мелких мелкие
гигантский: гигантские
рыба: рыб
анна: анна
жила: жил
восток: востоке
особый: особый
слой: слоями слои
нотобатрахов: нотобатрахов
уникальный: уникальную
уростиль: уростиль
поиск: поисках
неясный: неясным
вырастать: вырастали
музей: музее
жаба: жаб
доисторический: доисторические доисторических
фильтраторами: фильтраторами
айресе: айресе
протистов: протистов
пойма: пойма
новый: новое
помимо: помимо
примерно: примерно
рачков: рачков
лишенное: лишенное
взрослый: взрослое взрослых взрослого взрослой взрослую
времен: времен
задний: задние
вопрос: вопрос
метаморфоз: метаморфозом
разнообразный: разнообразны
раскопки: раскопки
уточнить: уточнить
превращение: превращению
поскольку: поскольку
современный: современные современных
единый: единый
перерыв: перерыва
источник: источник
образ: образ
самый: самые самых самый
всасывая: всасывая
набирать: набирать
доминирующий: доминирующий
стабильный: стабильным
древнейший: древнейшие древнейших древнейший древнейшая
журнал: журнале
найдено: найдено
динозавр: динозавров
вода: воды воду
органический: органический
причина: причин
отфильтровывания: отфильтровывания
отчетливого: отчетливого
чуливер: чуливер
остаток: остатки остатками
палеонтологический: палеонтологической
развитой: развитые
позвонок: позвонки
огромный: огромными
насекомое: насекомых
подтверждение: подтверждение
больший: больших
выцеживая: выцеживая
начаться: началась
провинция: провинции
амфибию: амфибию
матильда: матильда
окаменелость: окаменелостей окаменелость
гладкий: гладкой
глаз: глаз глаза
ближний: ближнем
путем: путем
случайный: случайно
безопасность: безопасности
сменяться: сменялся
меловом: меловом
икринки: икринки
морфологически: морфологически
смерть: смерти
пищать: пищи
сохраниться: сохранился сохраниться
жившего: жившего
летопись: летописи
представлять: представляют
юрские: юрские
голень: голени
крупный: крупные крупнее крупный
водоросль: водоросли
найден: найден
течение: течение
двустворчатый: двустворчатых
костя: костей
история: история истории
хвостовой: хвостовые
жаброногих: жаброногих
наземный: наземных
рекордсмен: рекордсмена
хрупкий: хрупкое
лягушачий: лягушачьи
отличимого: отличимого
удивительный: удивительно удивительных удивительные удивительной
статья: статьи
университет: университета
всякий: всякую
недавний: недавних
исследование: исследование
естественный: естественной
рисунок: рисунок
туловище: туловища
изученных: изученных
некоторые: некоторые
большой: большой
отличный: отлично
вместе: вместе
примечательный: примечательной
отсутствие: отсутствия отсутствие
сделать: сделали
велик: велики
модель: модели
обилие: обилием
предыдущий: предыдущего
экземпляр: экземпляров экземпляры
насыщая: насыщая
удивительнее: удивительнее
влажный: влажный
найти: нашли
вероятный: вероятно
заря: заре
жившей: жившей
относиться: относятся
косвенный: косвенное
ажурный: ажурный
стадия: стадиях
январь: январе
размер: размеры размеров размерам
временный: временных
встречаться: встречаются
выставленные: выставленные
велеть: вели
ранний: раннего раннем ранних
сила: силу
внимательный: внимательно
отфильтровывая: отфильтровывая
одновременный: одновременно
раз: раза
череп: череп
доказательство: доказательств
опубликованное: опубликованное
ископаемое: ископаемых
лондонском: лондонском
амфибии: амфибии
проталкивать: проталкивали
кровь: кровь
бульон: бульон
максимальный: максимально
обнаружено: обнаружено
триаса: триаса
нога: ноги
берег: берегам
текстуре: текстуре
питаться: питался питались
хищничества: хищничества
моллюск: моллюсков
присущий: присущий
раннеюрских: раннеюрских
короткохвостый: короткохвостый
специалистка: специалистка
гигантизм: гигантизма
насколько: насколько
новиковская: новиковская
онтогенез: онтогенеза онтогенезу
одному: одному
поддерживающий: поддерживающий
юго: юго
засуха: засухой
отряд: отряда
строение: строению строения
отличаться: отличались
территория: территории
момент: момент
средний: среднем
плохой: плохо
судя: судя
отнести: отнесли
получившийся: получившийся
поздний: позднем
изучить: изучила изучить
увидеть: увидеть
несмотря: несмотря
подводный: подводных
юрском: юрском
изобилующих: изобилующих
описать: описали
родственник: родственники
длинный: длинного длиннее
привлек: привлек
помочь: помог
мелочь: мелочь
учитывая: учитывая
мелового: мелового
исключено: исключено
нотобатраха: нотобатраха
первоначальный: первоначально
мелководный: мелководных
крепкий: крепкого
формация: формации
микроскопический: микроскопические
сохраняться: сохраняется
амфибий: амфибий
старый: старше
одним: одним
тело: тела
попасться: попался
такой: такими такого
одна: одна
помощь: помощью
бесхвостый: бесхвостых бесхвостые бесхвостой
вылупляться: вылупляется
ископаемый: ископаемой ископаемая
прыгать: прыгать
земноводный: земноводных
хрящ: хрящей хрящ
образец: образец
предмет: предметов
растительный: растительным
двухэтапный: двухэтапный
цикл: цикл
порода: породы породам
мариана: мариана
ученым: ученым
водоемах: водоемах
характерный: характерен
личинка: личинка личинки
одни: одни
свой: своим
сайт: сайта
разный: разный разных
оказаться: оказался оказалось
корень: корни
находка: находку
фото: фото
лужа: лужах
сезон: сезон
развиваться: развивается
изучены: изучены
юрского: юрского
патагонии: патагонии
мочь: могли
отпечаток: отпечаток отпечатки отпечатков
ракообразный: ракообразных ракообразные
находиться: находятся
множество: множество
внимание: внимание
круглоязычных: круглоязычных
нотобатрахи: нотобатрахи
панциря: панциря
животное: животное животных
период: периода периоде
длина: длину длина
походить: походили
размножаться: размножаются размножались
окостеневшему: окостеневшему
известный: известны известные известных известно
аргентинский: аргентинские аргентинской
водоемов: водоемов
ним: ним
примитивный: примитивных
всасывать: всасывать
готовиться: готовился
гигант: гигантом
водный: водный
тянуться: тянутся
кислород: кислородом
достигать: достигает
особь: особи
второй: вторых
сторона: стороны
вес: вес
растение: растений
заметный: заметны
соскребать: соскребать
сравнительный: сравнительной
речной: речная
первый: первые первых
вряд: вряд
санта: санта
обсуждаемой: обсуждаемой
мусор: мусор мусором
остается: остается
прыгун: прыгуном
невероятный: невероятно
конкуренция: конкуренции
млн: млн
сотня: сотни сотен
благодаря: благодаря
раскинуться: раскинулась
