эффект: эффект эффектом эффекты эффекте
благоприятный: благоприятное
дополнительный: дополнительных
одном: одном
развиваться: развиваются
работа: работы
неравенство: неравенство
богатство: богатство
проявляться: проявляется
модель: модели
меняться: меняется
привередливость: привередливость
усредняться: усредняться
каждый: каждой каждом каждую каждому каждого
обсуждаемой: обсуждаемой
влияние: влияния влияние влиянием
другой: другом другую другими
исследователь: исследователей
ожидать: ожидать
ночь: ночь ночи
благодаря: благодаря
возникающие: возникающие
ныне: ныне
привлекательный: привлекательные
генофонд: генофонд
проводившийся: проводившийся
побеждать: побеждает
связь: связь
снижать: снижает
заслуга: заслуг заслугами
измеряемыми: измеряемыми
конкуренция: конкуренция конкуренции конкуренцией
ранее: ранее
наверное: наверное
многие: многом
убедительность: убедительность
фиксированными: фиксированными
хищник: хищников хищники хищнику
пообедать: пообедал
одновременный: одновременно
ним: ним
отмечать: отмечают
различие: различия различий различиями
ресурс: ресурсами ресурсы ресурсам
дневной: дневном дневного
собранный: собранных собранные
побывать: побывал
мышонок: мышат мышонка мышонку мышата
поначалу: поначалу
известный: известно
материнский: материнским
аналогичный: аналогичным
видимый: видимому
продолжать: продолжала
одинаково: одинаково
действие: действием
лес: лесу
везунчик: везунчик
ключевой: ключевую
основа: основе
занять: занять
отбор: отбора отбор
взгляд: взгляд
формируются: формируются
вероятность: вероятностью
поскольку: поскольку
парадокс: парадокса
окончательный: окончательно
экспериментальный: экспериментальной экспериментальных экспериментально экспериментальную экспериментальные
автоматический: автоматическая
выглядеть: выглядят
анализ: анализ
транслируются: транслируются
рассуждение: рассуждения
объяснение: объяснений
статистика: статистики
фотография: фотографии
формируется: формируется
двух: двум
предполагать: предполагают
повышающие: повышающие
преимущество: преимущество преимуществах
усиление: усилении
установленный: установленные
взаимоотношение: взаимоотношения
имеющийся: имеющиеся
перебегать: перебегала перебегать
масса: массой массе
мутационного: мутационного
стечение: стечения
отслеживали: отслеживали
основный: основном
должный: должны
представлявший: представлявший
объясняться: объясняется объясняться
случай: случая случае
полова: полов половой
внутренний: внутреннее
взрослый: взрослыми взрослое
подобный: подобных подобного
противоположный: противоположного
рассматриваемые: рассматриваемые
корнеллского: корнеллского
заключаться: заключается
явление: явление
подрались: подрались
противный: противном
ожидание: ожидания
наукообразный: наукообразно
иллюстрировать: иллюстрирует
поэтому: поэтому
изначальный: изначально
исследовательский: исследовательское
сигнал: сигналам
абсолютный: абсолютно
момент: момент
биология: биологии
токовище: токовища
интересный: интересны
возраст: возрастом возрасту возраст возрасте возраста
дефицитными: дефицитными
любопытный: любопытном
начинать: начинает
заставлять: заставляют
прогнать: прогнал
одиночество: одиночестве
возникшие: возникшие
позиция: позиции
жизнь: жизни
обсуждаться: обсуждается обсуждаются
проведенного: проведенного
площадка: площадки площадку площадке
поведенческий: поведенческие поведенческих поведенческая
матфея: матфея
степень: степени
какой: какими какому каком каким какую
общий: общей
вес: вес весе
подразумевать: подразумевают
неимеющего: неимеющего
подопытный: подопытных
средний: средний среднее среднем
экологически: экологически
социум: социуме
справа: справа
система: системы
питаться: питаться питался
расти: расти растут
показывающие: показывающие
наблюдаться: наблюдалось
поверить: поверил
публикуемые: публикуемые
примерно: примерно
сказать: скажем
приходиться: приходится
выявленные: выявленные
гнездовой: гнездовая
длительный: длительных
включая: включая
показатель: показателей показателя показатель
природа: природе
репродуктивный: репродуктивный
приведенной: приведенной
относящися: относящися
нивелировать: нивелировать
огороженный: огороженной огороженную
проходящую: проходящую
социология: социологии
приумножиться: приумножится
полный: полный
посмотреть: посмотреть
эксперимент: эксперименте эксперимент эксперимента
оставленный: оставленных
признак: признаков признаки признак признака признакам
положительный: положительную положительно
хороший: лучший
стандартный: стандартной
переселение: переселения
приведен: приведен
главный: главная главной
взаимодействие: взаимодействий
модностью: модностью
период: период
компонент: компонентам компонента
фенотипическая: фенотипическая
закрепиться: закрепятся
возникавшие: возникавшие
неиссякающая: неиссякающая
остальное: остальных
стать: стали
действующий: действующих
иной: иной иную иными
нашем: нашем
мышиный: мышиными
выводя: выводя
дарвиновскую: дарвиновскую
косвенно: косвенно
источник: источник
идентичный: идентичных идентичными
начальный: начальное
уютный: уютными
помогать: помогает
заметить: замечу
одинаковый: одинаковых
мышь: мышь мышах мышами мыши мышам
устойчивый: устойчивые
идет: идет
различаться: различались
долить: долей
качество: качествами
меритократии: меритократии
идентификация: идентификации идентификаций
оценка: оценка
конкурировать: конкурировали конкурируют конкурировать
привести: привело
зрелость: зрелости
усиливая: усиливая
ситуация: ситуация
партнеров: партнеров
друг: друг друга
положение: положении
статус: статус
день: дни дня дней
представитель: представителем
гость: гостей
способность: способностей
ниша: нишу
сделать: сделать
главное: главным
график: графики график
назвать: назвали
повторностей: повторностей
мелкий: мелкие
особь: особей особи особь особями
потомок: потомков
роль: роль
способствовать: способствует
коррелировать: коррелировать
сексуальный: сексуально
задуматься: задуматься
пополняемая: пополняемая
усиливать: усиливали усиливать
зависеть: зависят зависела зависеть
голодный: голодным голодного
проследить: проследить
продолжаться: продолжались
встреченных: встреченных
справедливый: справедливо
моделирование: моделирования
вживленными: вживленными
биолог: биологи
лабораторный: лабораторной
формировалась: формировалась
слово: словами
месяц: месяцев
основание: основания
антенный: антенна антенны
течение: течение
столько: столько
представить: представить
соображение: соображения
иметь: имеет имеем
трудный: трудно
часы: часов
радиочастотной: радиочастотной
сгладить: сгладили
происходить: происходит
устройство: устройство
камера: камера
статья: статьи статье статья
исследование: исследовании исследование исследования
быстрый: быстрее
имеющий: имеющему имеющие
поведение: поведении поведение
некий: некий
лидирущие: лидирущие
дрозофил: дрозофил
единичный: единичный
четырьмя: четырьмя
оборона: оборону
выражены: выражены
усиливаться: усиливаются усиливались усиливаться
изощренной: изощренной
событие: события
теория: теории
связанный: связанных
отстающими: отстающими
нарастание: нарастание
регистрировавшая: регистрировавшая
мышей: мышей
последующий: последующие
склонность: склонность
автор: авторы авторов
показан: показан
использовалась: использовалась
расходящиеся: расходящиеся
добыча: добычу
конкурентоспособнее: конкурентоспособнее
всесилие: всесилии
неотразимый: неотразимыми
неряшливость: неряшливости
иметься: имеются
комфортными: комфортными
набирать: набирали
убрать: убрать
дело: деле
цена: цена
выводок: выводками выводки выводках выводков
траектория: траектории
лужайка: лужайке лужайку
вход: вход
который: которым которыми которое
показывать: показывают показывает
синий: синие
дать: дали
предположительно: предположительно
составлять: составлял
смерть: смерти
доступ: доступ
материал: материалов материалах
самец: самцов самцы самцами самца самцу самец
установить: установили
создает: создает
женский: женским женский
важный: важных важно
домовый: домовых
соответствовать: соответствует
александр: александр
марков: марков
единственный: единственный
социальный: социальной социальных социальный социальную социальные
идея: идеей идея идеи идею
иерархия: иерархии
переход: переходов
мобильность: мобильность
малодушный: малодушно
неширокий: неширокую
отражающих: отражающих
вероятный: вероятно
груз: груза
допущение: допущения
осмелиться: осмелюсь
трубка: трубку
идущим: идущим
изучать: изучать
диапазон: диапазон
сформировались: сформировались
влиять: влияет
проверка: проверки
успешность: успешности успешность
доминантные: доминантные
человек: людях людей
одному: одному
территориальный: территориальными
правдоподобный: правдоподобно
невелика: невелика
трехнедельном: трехнедельном
индекс: индексом
обосновывать: обосновывают
вид: виду
принадлежать: принадлежала
провести: провели
интенсивность: интенсивность
повезти: повезло
охота: охоту охоты
практически: практически
теоретический: теоретических
отражающим: отражающим
изменчивость: изменчивости изменчивость
низкий: низкими
интервал: интервалах
отняться: отнимется
попытаться: попытались
популяция: популяциях
пластиковый: пластиковую
контроль: контроль
статистический: статистическая статистическими
превосходить: превосходили
устоявшиеся: устоявшиеся
пресловутый: пресловутого
удача: удачей удачи
повлиять: повлиять
встретиться: встретились
предположение: предположения
среди: среди
ген: генам гены генов
определяться: определяются определяется
обстоятельство: обстоятельств
первый: первому первых первая первые первом
помещение: помещения
регистрировать: регистрировать
конкурентоспособность: конкурентоспособность
разместить: разместили
число: число
играть: играть
одним: одним
связаны: связаны
тело: тела
начало: начале
посещенных: посещенных
образ: образом
рис: рис
оттеснялись: оттеснялись
выгодный: выгодно
генофонда: генофонда
индентификаций: индентификаций
влияющим: влияющим
вроде: вроде
дизайн: дизайн
сша: сша
релевантными: релевантными
список: список
вывод: выводов
выигрышный: выигрышном
речь: речь
особенность: особенностями особенности
занимать: занимает
подтвердить: подтвердили подтвердил
рост: росту
оставшаяся: оставшаяся
сторона: стороны
линия: линии
обработка: обработка
регулярный: регулярно
например: например
сытый: сытый
незначительный: незначительные
дожили: дожили
начиная: начиная
заключение: заключение
наткнуться: наткнулся
прежних: прежних
жила: жила
идеологический: идеологической
показать: показал показать
активный: активно
таки: таки
сведены: сведены
сочетание: сочетании
двойственный: двойственное
выход: выход
дальнейший: дальнейшем дальнейшему
социологический: социологической
позволять: позволяли позволяют
данный: данная данном данному данного данный
опубликованы: опубликованы
динамика: динамику динамики
вживить: вживили
красный: красные
стресс: стресса
равный: равен равно
разный: разные разной
выровнять: выровнять
данные: данных данным данные
вместе: вместе
аргумент: аргументами
сутки: суток
даться: дастся
попытка: попыток
свободный: свободно
случайность: случайности случайностью случайностей
находиться: находилась
выделяться: выделяются
весомее: весомее
такой: таких такого таким
нарастать: нарастали нарастать
просторечие: просторечии
скорый: скорее
пища: пище
приспособленность: приспособленность
отличаться: отличается
индивид: индивида индивидами индивид индивидов
обоих: обоих
молоко: молоком
постепенный: постепенно
значительный: значительной
впечатление: впечатление
сфотографировать: сфотографировать
американский: американские
наука: науках
мнение: мнению
обзавестись: обзавестись
доля: доля
временный: временных
успех: успех успехе успеха успехом
условие: условиях условия
алгоритм: алгоритму
сложность: сложности
доминантность: доминантность
задворки: задворки
параметр: параметрами
захватить: захватить
самоподдерживающиеся: самоподдерживающиеся
нагруженностью: нагруженностью
сильный: сильнее сильный
животное: животных
потомство: потомством потомство
индивидуальность: индивидуальность
развитие: развитие развития
называть: называют
причина: причины
набюдалось: набюдалось
испытывать: испытывал
домик: домиков домика домике домиками домик домиках домики
биологический: биологической
естественный: естественными
предсказать: предсказать
конец: конце
самостоятельный: самостоятельной
сразу: сразу
позволить: позволила позволило
увеличиваться: увеличиваются увеличиваться
модный: модную
поместить: поместили
помощь: помощи
снежный: снежный
перемещаться: перемещаются
полагать: полагают
косвенный: косвенными
вопрос: вопросах
присходило: присходило
остаться: остался
весть: вести
эксклюзивный: эксклюзивный
лидер: лидерами
индентификации: индентификации
участок: участок
второй: вторых второму вторая втором
метр: метров
слева: слева
вычислялся: вычислялся
разница: разница
подкреплять: подкрепляет
непрошеный: непрошеных
цель: целью
везение: везения везением везение везению
никак: никак
собственный: собственным собственное
больший: большей большим больших
победа: победа
подрывать: подрывает
подтверждение: подтверждений
оставлять: оставляет
пояснять: поясняют
находящимися: находящимися
сумма: сумма
утратить: утратит
произвести: произвести
научный: научной
непредсказуемые: непредсказуемые
университет: университета
лаборатория: лаборатории
успеть: успели
пола: пола
устойчивость: устойчивость
счет: счет
автокаталитическое: автокаталитическое
элемент: элементы
закрепляться: закрепляться
отличие: отличие
превосходство: превосходство
выясниться: выяснилось
наблюдение: наблюдения
показано: показано
согласоваться: согласуются согласуется
простой: простой
сложный: сложная
мочь: могли
уровень: уровня
кормушка: кормушка кормушками
следить: следили
среда: среды
проводившихся: проводившихся
становиться: становится
похожий: похожим
прекращать: прекращают
эволюционный: эволюционной
показанный: показанный
самка: самок самками самки
журнал: журнале журналах
ход: ходе
кожа: кожу
место: место
получать: получает
отражать: отражает
мужской: мужских
облегчать: облегчало
жизненный: жизненный жизненном жизненного
генетический: генетически генетическими
неудачник: неудачники
литература: литературе
выискивать: выискивать
двухнедельный: двухнедельных
метка: метками метку метки
генетик: генетику
эффективность: эффективность
небольшой: небольшие
популярный: популярной
слепой: слепого слепому слепым слепой
размер: размером
особый: особо
половой: полового половых
рисунок: рисунке рисунок
сотня: сотню сотне
перемещение: перемещениями перемещения
физический: физическое
вряд: вряд
результат: результате результаты результат
случайный: случайные случайного случайной случайным случайно
талант: талантов талантами
последствие: последствия последствий последствиям
рассмотреть: рассмотрели
реальный: реально
иллюстрация: иллюстрация
отправившихся: отправившихся
род: рода роду
оказаться: оказаться оказалось
высокий: высоким высокими
группа: группами группы группе
использовался: использовался
название: названием
соперник: соперником
пример: пример примере примеры
значение: значением значениями
обратный: обратную
количество: количеством
очищать: очищать
итоговый: итоговое
личной: личными
оценивать: оценивать
