клетка: клеток клетки
питательный: питательных
взгляд: взгляд
поныне: поныне
сопровождающееся: сопровождающееся
вкусный: вкусную
план: планом план
небольшой: небольшом
проаннотированы: проаннотированы
годы: годы
массив: массиве
вирус: вирусы вирусами вирусов
дифференцировка: дифференцировка
дополнительный: дополнительные
реализоваться: реализовался
познакомить: познакомили
объесть: объем
тип: типа
закономерность: закономерности
геном: геномов геномах геномы
несмотря: несмотря
начало: начале
различаться: различались
статистический: статистического
подобный: подобное
получить: получим
история: историю
событие: событий
аппарат: аппарат аппарата
объяснять: объясняет
возможность: возможность
возникновение: возникновению
наземный: наземных наземными
прийти: пришли
клеточный: клеточных клеточную
который: которое которую
лейкемия: лейкемию
полный: полных
энергия: энергии
оставить: оставили
фото: фото
среди: среди
материал: материалы
возможный: возможно
слизевик: слизевик
напоминать: напоминает
группа: групп группа группам группах группе группы
скромный: скромными
ответить: ответить
собрат: собратьев
способность: способность
становиться: становился
десяток: десятков
примитивный: примитивных примитивная примитивный
минимум: минимум
одному: одному
изобрести: изобрели
зелёный: зелено
высокий: высокую
скучный: скучно
одном: одном
сложный: сложную сложным
неожиданный: неожиданное
толочь: толку
тотальную: тотальную
относительный: относительно
далеких: далеких
макроводорослей: макроводорослей
хромат: хромата
плацента: плаценту
предпосылка: предпосылки
рисунок: рисунок
водорослевых: водорослевых
эволюция: эволюции
позволить: позволили
листочек: листочке
перестройка: перестройкой
обсуждаемой: обсуждаемой
подарившими: подарившими
исследование: исследование
международный: международная
побег: побегов побега
линия: линии линий линиях
раз: раза
оаэ: оаэ
полярность: полярности
вещество: веществ
работа: работе
мешать: мешал
экспансия: экспансия
обмен: обменом
нашпигованными: нашпигованными
крупный: крупным крупных
набор: набор
мембрана: мембран мембрану
правда: правда
альтернативный: альтернативный
разный: разным разного разные разных
связанный: связанный связанных
ион: ионов
обзавестись: обзавелись
матрикса: матрикса
таковой: таковой
ситуация: ситуацию
сайт: сайтов
белковый: белков
создание: создание
проявление: проявлению
масштаб: масштаба
растение: растений растениями растения
филогенетическое: филогенетическое
насколько: насколько
больший: большем большим
водоросль: водорослей водоросль водоросли водорослях водорослями
одноклеточный: одноклеточных одноклеточными
критический: критическую
концентрация: концентрацию
кучка: кучкой
сам: самое
впервые: впервые
обретение: обретений
далеки: далеки
цепь: цепью
база: базах
предок: предками
сообщество: сообществу
тема: тему
максимальный: максимально
представленный: представлена представлены
изобретать: изобретала
значительный: значительно
установление: установлением
соответствующий: соответствующие соответствующими
правильный: правильнее
функция: функции
направо: направо
дерево: дерево
использованный: использованы
иначе: иначе
сравнение: сравнению
цветок: цветка
источник: источник
рис: рис
многоклеточный: многоклеточными многоклеточных многоклеточным многоклеточного многоклеточный
генетический: генетические генетическими генетический генетического
собирательный: собирательная
оказываться: оказываемся
дело: дело
великобритания: великобритании
разветвленной: разветвленной
богатство: богатство
привнесена: привнесена
вызывающий: вызывающими
бурый: бурая бурые бурых
ген: генов гены генами
сосудистый: сосудистой
фундаментальный: фундаментальные
разветвленные: разветвленные
цинк: цинка
предыдущий: предыдущих
поддержание: поддержания
такой: такого таких
живой: живого
форма: форм формы формам
млрд: млрд
период: периода
ожидаемы: ожидаемы
выглядеть: выглядит выглядят
формирование: формировании формирования
древние: древними
интригующий: интригующие
стать: стать стали
юрского: юрского
сдвиг: сдвиг
процесс: процессе процессы
случиться: случилось
днк: днк
красный: красная красные красных красными
недостаток: недостаток
прийтись: пришлось
аминокислота: аминокислот аминокислоты
жасмоновую: жасмоновую
возникать: возникала возникает
эукариот: эукариот
талломов: талломов
мерка: меркам
какой: какими каких какое какую
выяснить: выяснить
вытянуть: вытянуть
резонный: резонный
указывать: указывает
характерный: характерно
неясный: неясно
ретровирусами: ретровирусами
биоинформатики: биоинформатики
морфология: морфологии
гомологи: гомологи
возникшие: возникшие
информация: информацию информация
описать: описать
независимый: независимых независимо
образование: образованием
сопровождаться: сопровождаться
организм: организма организмов организм
генный: генная
отличаться: отличаются
оставшиеся: оставшиеся
заключение: заключение
давших: давших
цветковый: цветков
геномные: геномные
научный: научному
заметный: заметно
цитоскелета: цитоскелета
таксоне: таксоне
ученые: ученые
запоминать: запоминать
куракин: куракин
основный: основных
гриб: грибами
эволюционный: эволюционные
вопрос: вопрос
функциональных: функциональных
количество: количестве количеством количество
пространственный: пространственно
показаться: показаться
прочтение: прочтением
решение: решений
оказаться: окажутся
поэтому: поэтому
анализ: анализа
расширить: расширили
переносящих: переносящих
репертуар: репертуара
биологический: биологической
относящихся: относящихся
млн: млн
масштабный: масштабными
специализация: специализацией
распад: распада
интересный: интересно интересное
семейство: семейств
транспортеров: транспортеров
мочь: могла
происхождение: происхождения
близкий: близкими
возникнуть: возникли возникла
сходство: сходство
разрастись: разросся
немощный: немощной
использовать: использовали
первоначальный: первоначально
наверняка: наверняка
обнаружить: обнаружат
внешний: внешнее
появиться: появились
затрата: затраты
отношение: отношение
участвовать: участвуют
необходимый: необходимы
отметить: отметим
слева: слева
настолько: настолько
геохронологическим: геохронологическим
отдельный: отдельно
конвергентно: конвергентно
межклеточный: межклеточного
заранее: заранее
сотня: сотни сотен
сервис: сервисов
изобретение: изобретению
ближайший: ближайших ближайшие
большой: большой
терять: теряли
фитогормоны: фитогормоны
счет: счет
столь: столь
микроводорослей: микроводорослей
перепись: перепись
выиграть: выиграли
арсенал: арсенал
первый: первая
сведение: сведения
успех: успехи
онтология: онтология
наработки: наработки
заражать: заражали
секвенированные: секвенированные
архепластид: архепластид
родственник: родственниками родственников родственники
реакция: реакции
природа: природа
колоссальный: колоссальный
спирогира: спирогира
прочесть: прочла
сложность: сложности
очевидный: очевидным
запастись: запаслась
случайность: случайности
провести: провести
сходный: сходным
достаточный: достаточным
самый: самые самый самая
фрагмент: фрагменты
публикуются: публикуются
фотосинтезирующих: фотосинтезирующих
зеленые: зеленые
обогащение: обогащение
проект: проекта
цветками: цветками
современный: современное
макроводоросли: макроводоросли
сша: сша
зеленых: зеленых
развитие: развития развитию развитии
число: числу
статья: статьи статье
полисахаридов: полисахаридов
сценарий: сценарий
спид: спид
порождать: порождает
метаболических: метаболических
последний: последние
комплексный: комплексными
классификация: классификации
иметь: имеет имела
кислота: кислоту
представитель: представители представителями
зеленая: зеленая
многоклеточность: многоклеточность
являться: являются
ход: ходе
разделены: разделены
гормон: гормонов
наблюдать: наблюдать
новый: новых новые
многоклеточности: многоклеточности
секвенировать: секвенировать
пытаться: пытались
любой: любой любое
этап: этапов
поражать: поражать
ученых: ученых
данные: данные данных
накопиться: накопились
включать: включает
поглощение: поглощение
сбивать: сбивать
пожаловать: пожалуй
продолжать: продолжают
вывод: выводы
решен: решен
относящиеся: относящиеся
мощнейший: мощнейших
выясниться: выяснилось
друг: друг друга
общий: общими общей общем
формировать: формировать
страменопилов: страменопилов
вольвоксовые: вольвоксовые
посмотреть: посмотреть
строение: строением
собрать: собрать
яркий: яркому
рекордсмен: рекордсменами рекордсменом
тканевый: тканевым
ткань: ткани
обогатиться: обогатились
довестись: довелось
чистый: чистой
представляться: представлялись представляются
георгий: георгий
трех: трех
причастный: причастны
изменение: изменениями изменения изменение
необходимость: необходимость
приобрести: приобрели
мир: мир
расшифрованных: расшифрованных
продемонстрировать: продемонстрировали
часть: часть
