зеленые: зеленые
исходить: исходит
обсуждаться: обсуждаются
работающих: работающих
резкий: резко
уловка: уловку уловка
наблюдаться: наблюдалось
миро: мире
справа: справа
бассейн: бассейне
автор: авторы авторам
шуйфа: шуйфа
сорт: сортов
поймать: поймать
источник: источник источнику источника источников
сравнение: сравнение
сближаться: сближаются
двигаясь: двигаясь
инвертированный: инвертированный
обманный: обманную
внутри: внутри
рыба: рыбы рыб
использовать: используют использовали
шелест: шелест
находиться: находится находилась
руководитель: руководитель
компонент: компонентов компонента компоненты
новость: новость
одну: одну
вызываемое: вызываемое
вопрос: вопрос
соединенный: соединенный
способный: способны способен
живем: живем
журчание: журчание
журнал: журнала
сгущение: сгущение
соответственный: соответственно
данионеллы: данионеллы
веберова: веберова
наземный: наземные
эффект: эффект
опасность: опасности
благодаря: благодаря
повторить: повторил
сопроводительный: сопроводительных
иллюзия: иллюзии
ткань: ткани
боковая: боковая
нервный: нервные
нашим: нашим
сразу: сразу
обратно: обратно
астериски: астериски
университет: университета
строгий: строгое
видный: видно
следующий: следующим
иначе: иначе
необходимый: необходимые необходимым
сжиматься: сжимался
обрабатываться: обрабатываются
давая: давая
трава: травы
ладоши: ладоши
сторона: сторону стороны
северный: северная северной
видимость: видимости
сенсорный: сенсорные сенсорным
миниатюрный: миниатюрный миниатюрными
ластик: ластик ластика
проверить: проверить
центр: центре
пространство: пространстве
направо: направо
стремиться: стремились
правомерность: правомерность
установленный: установлено
рыбка: рыбка рыбке рыбками рыбки рыбок рыбку
работать: работает работали
давление: давления давление
дальнейший: дальнейших
используется: используется
вода: водой воду вода воды
внимание: внимание
механизм: механизм механизма механизмов механизмы
описать: описать
среда: среде среды
заметный: заметно
экспериментальный: экспериментальные
линия: линии
соотношение: соотношение
слышать: слышат
записаны: записаны
проверка: проверки
акустический: акустическую акустической
место: места месте
именоваться: именоваться
инструментарий: инструментарием
передаваться: передавалось передаваться
особенность: особенностью
ним: ним
отвечать: отвечают
послушать: послушать
такой: такую таким
микрон: микрона
левый: левым левое левом
природный: природных
колонка: колонок колонка колонки колонкой колонке колонками
образ: образом
проводимость: проводимость
поступь: поступью
найти: найти
эксперимент: эксперимент
изолированный: изолированные
использование: использованием использование
направлено: направлено
отолитов: отолитов
установить: установили
предстоять: предстоит
порождать: порождает
сигнал: сигналы сигнал сигнала
распространяться: распространяется
лёгкий: легко
растягиваться: растягивался
нырнуть: нырните
случайность: случайность
видео: видео
проведенное: проведенное
анализатор: анализатором анализатора анализатор
веберов: веберов
крадущийся: крадущейся
таки: таки
физика: физике
шаг: шагом
крупный: крупные
помощь: помощью
движущиеся: движущиеся
статья: статьи статье
данные: данные
воссозданный: воссозданный
улавливаться: улавливаться
получить: получить
аквариум: аквариум аквариуму
дернулись: дернулись
решать: решают
изменение: изменение
черные: черные
перетягивать: перетягивали
параметр: параметры параметров
дело: дело
должный: должны должна
многие: многие
специальный: специальные
иметь: имеют
тремя: тремя
действие: действием
красный: красные
оси: оси
цель: целью
таковой: таково
включающий: включающий
заметить: заметил
локализация: локализации
вообще: вообще
щелбана: щелбана
обман: обман
происходить: происходит происходить
объяснение: объяснение
включая: включая
толчок: толчка
весь: всей
попросить: попросите
отдельный: отдельных отдельные отдельно
поведение: поведение
состоящее: состоящее
смещать: смещают
хватать: хватает
пик: пике
ситуация: ситуацию
посвященном: посвященном
попросту: попросту
меньший: меньшей
аппарат: аппарата аппаратом аппарат
подтвердиться: подтвердилось
наблюдать: наблюдали
восприятие: восприятия
реагировать: реагируют реагировать
берлин: берлине
маленький: мал
согласный: согласно
показана: показана
увеличиваться: увеличивалась
откуда: откуда
слева: слева
анимация: анимация
предположить: предположил
посмотреть: посмотреть
оставаться: оставалось оставался
подаваться: подавался
тип: типа
помогать: помогает
тень: тень тени
ключевой: ключевое
находящихся: находящихся
рис: рис
приближающейся: приближающейся
крыться: кроется
создает: создает
плыть: плыть
синхронный: синхронно
зафиксированную: зафиксированную
окружающий: окружающей окружающие
пузырь: пузырь
сообщать: сообщает
используя: используя
совпадать: совпадает
похлопать: похлопать
создавая: создавая
называемое: называемое
уронить: уронил
противофазе: противофазе
принципиальный: принципиально
марков: марков
точка: точки точек
состоять: состоит
воздух: воздухе воздуха воздух воздуху
ручей: ручья
ответ: ответ
стразу: стразу
агарозе: агарозе
обе: обе
важный: важно важной
частица: частиц частицы
внутренний: внутреннее внутренним внутреннего
реакция: реакцию реакция реакции
инвертированную: инвертированную
противоречить: противоречит
связанный: связанный
вызывать: вызывает
пренебрежимо: пренебрежимо
неправильный: неправильную
хитроумный: хитроумных
колебание: колебаний колебания колебание
гипотетический: гипотетическую
движение: движение движения
ученым: ученым
вайт: вайт
исследование: исследование исследованиях исследовании исследования
молекула: молекулы
улавливать: улавливать
сбоку: сбоку
север: север
звук: звуки звука звук звуков звуком
размер: размер
использующую: использующую
упавший: упавшего
показывать: показывает показывают
шарить: шарите
сайт: сайта
удачный: удачным
нерв: нерву
случай: случае
инвертировать: инвертировать
удаться: удалась
приходить: приходят приходит
правый: правым правое правом
группа: группой группе
стереосистемах: стереосистемах
водный: водные
называемую: называемую
пришел: пришел
зеркальный: зеркально
вовремя: вовремя
например: например
максимальный: максимально максимального
идея: идее
фаза: фазу фаза фазе фазой
проверяющие: проверяющие
передающиеся: передающиеся
система: системой
знание: знание
приход: прихода
закрыть: закройте
конфигурация: конфигураций конфигурации
чувствительный: чувствительных
сравнивая: сравнивая
минимальный: минимально
смотреть: смотрела
колебаться: колебалось
умение: умение
поэтому: поэтому
подобный: подобные
данионеллами: данионеллами
обычный: обычный
первый: первых первое
смещение: смещение
определение: определения
использованный: использованных использован
хищник: хищника
удалось: удалось
одинаковый: одинаковой
отличный: отлично
создаваться: создаются
обездвиженными: обездвиженными
способность: способности способностью
крохотный: крохотные
дергалась: дергалась
южный: южная южной
амплитуда: амплитуда амплитудой
загадка: загадкой
арье: арье
предсказание: предсказания предсказание предсказаний
компенсировать: компенсировало
влияние: влияние
условный: условно
называемой: называемой
подача: подачи
оттуда: оттуда
воспринимать: воспринимать
выяснить: выяснить
отбрасывать: отбрасывает
разница: разницу разница
фазовое: фазовое
изменяющееся: изменяющееся
услышать: услышите
двигаются: двигаются
синтетический: синтетически
ученых: ученых
принять: принять
определить: определить определите
бинауральное: бинауральное
пример: пример
веберовым: веберовым
пузырем: пузырем
слуховой: слуховой слухового слуховым слуховых слуховому
даниил: даниил
принцип: принципу
импульс: импульсы
уха: ухе уха
локальный: локального
копия: копии
род: рода
способ: способ
понять: понять
изучение: изучения
тянуть: тянули
камешек: камешков
нейрон: нейронов
рисунок: рисунок рисунке
направление: направление направлении направления направлением направлению
примерно: примерно
сказать: скажем
движущуюся: движущуюся
звуковой: звуковой звуковую звукового
йоханнес: йоханнес
отражены: отражены
манипуляция: манипуляций
близкий: близкого
гидрофон: гидрофон
вдоль: вдоль
обсуждаемой: обсуждаемой
плохой: хуже
совершенный: совершенно
дергались: дергались
равный: равно
уплывать: уплывать
указывать: указывало
сложнее: сложнее
оказаться: окажетесь оказались оказалось
вперед: вперед
плавать: плавали
издаваемый: издаваемый
мелкий: мелких мелкие
микроскоп: микроскоп
частить: части
данный: данном
выйти: выйдет
изучен: изучен
универсальный: универсален
часть: частей частях
разрешающей: разрешающей
друг: друг друга
момент: момент
издавать: издают издавала издавали
убедившись: убедившись
окружать: окружают
гул: гул
помещать: помещали
анимацию: анимацию
хитрый: хитрых
колеблющегося: колеблющегося
метода: метод
голос: голос
достаточный: достаточно
десятилетие: десятилетия десятилетий
относительный: относительную относительной относительно
толкать: толкают толкала
фиолетовый: фиолетовые
иной: иной
гораздо: гораздо
задались: задались
лабиринт: лабиринта
клетка: клетках клетками
недавний: недавнее
элемент: элементы
известный: известно
существовать: существуют
объект: объектом
притягивания: притягивания
информация: информацию
лапилли: лапилли
задержка: задержки задержку задержка
машина: машины
голова: голову голова головы
казаться: казаться
второй: вторых втором
косточка: косточки косточек
улавливаемые: улавливаемые
сенсора: сенсора
накладывались: накладывались
ориентироваться: ориентироваться
разный: разные
проходить: проходит
появление: появления
компонетов: компонетов
модель: модель модели моделей
сенсор: сенсор
обсуждаемом: обсуждаемом
вместе: вместе
орган: орган органы
определять: определять определяют определяли
животное: животные животных
задача: задачу
уловить: уловить
быстрый: быстрее
громкость: громкости
разрежение: разрежение
человек: людей человека
фазовых: фазовых
помочь: помогла
находившаяся: находившаяся
убедиться: убедиться
прямой: прямой прямую прямого прямое
измерить: измерить
руководствуясь: руководствуясь
конфокальный: конфокальный
взаимодействовать: взаимодействуют
двигаться: двигаться движутся двигались
придумать: придумали
единственный: единственной
воспринимаются: воспринимаются
каковой: каковы
ухо: ухом ухо ушами
показать: показало показать
упасть: упал
очевидный: очевидно
пересиливать: пересиливало
получаться: получалось
пар: пары
удается: удается
дальний: дальнее
процесс: процессов
влево: влево
стоять: стояли
волосок: волоски
мозг: мозге мозг мозга
записать: записал записали
либо: либо
удалиться: удалиться
инвертированная: инвертированная
ощущение: ощущение
установка: установку
подкасте: подкасте
меньшой: меньшую
отдаляться: отдаляются
тянутый: тянут
саггиты: саггиты
мотор: мотора
отношение: отношение отношений
полученные: полученные
плавательный: плавательный плавательным
альтернативный: альтернативные
игнорировать: игнорировать
начинаться: начинаются начинается
стать: станет
отолиты: отолиты
обладать: обладают
материал: материалов
волна: волны волну волне волна
причем: причем
потребоваться: потребуется
издающей: издающей
траектория: траекторию
боковой: боковой
громкий: громче громкие
предложить: предложил
вправо: вправо
большинство: большинство
одним: одним
создание: создания
изначальный: изначальное
волосковыми: волосковыми
выясниться: выяснилось
глаз: глаза
шуйф: шуйф
меняться: менялись
