жаберный: жаберный
развивающийся: развивающиеся
утверждать: утверждают
обеспечиваться: обеспечивалась
практически: практически
другой: другом другими
успешный: успешная
гетеростраков: гетеростраков
извлеченных: извлеченных
обойти: обойти обошли
морфологически: морфологически
бугорок: бугорками
осадка: осадка
позволить: позволили позволила
исследователь: исследователи исследователями
вода: воды
реконструкция: реконструкция реконструкцию реконструкции
раздвигаться: раздвигаться
противник: противникам
вымерший: вымершая
частица: частиц
смыкаться: смыкаются
выпуклый: выпуклая
фильтрационным: фильтрационным
плезиоморфным: плезиоморфным
задача: задача
состав: составе
твердых: твердых
расширение: расширению расширение
гетеростраками: гетеростраками
указывать: указывает
главный: главная главной
анна: анна
ротовой: ротового ротовой ротовых ротовые ротовая ротовое ротовыми ротовым
служить: служат
называть: называют
сравнивая: сравнивая
режущий: режущая
разнообразия: разнообразия
общий: общего
животное: животных животного
покрытый: покрыто
стать: стать
отвергнуть: отвергнуть
девон: девон девона
функция: функций функции
оснащен: оснащен
ограничение: ограничения
форма: формы форма
переход: переход
морской: морских морской
высокий: высокую
способный: способны
цельный: цельного
набор: набор
полный: полном
схожесть: схожесть
эволюционный: эволюционными эволюционно
миксины: миксины
крепления: крепления
челюстноротых: челюстноротых
аспидина: аспидина
точный: точно
кусать: кусать
зачерпывать: зачерпывать
единственный: единственным
вид: вида виде вид
фильтр: фильтр
сохранивший: сохранивший
детрит: детритом
сбоку: сбоку
близкий: близких
согласный: согласно
нижний: нижняя нижней
аналогия: аналогии
пластина: пластин
сила: силу
зародышевый: зародышевых зародышевым зародышевый
дает: дает
задолго: задолго
нейрогенных: нейрогенных
хищник: хищниками
роль: роль
обсуждаемой: обсуждаемой
рис: рис
существовавшая: существовавшая
просвет: просвет
предложенная: предложенная
норткатта: норткатта
частность: частности
кусание: кусания
хватания: хватания
построенной: построенной
недавний: недавней
важный: важными важную
движение: движения движений
каталожный: каталожный
полностью: полностью
предполагать: предполагали предполагают
вывод: выводы
дивергировали: дивергировали
беспозвоночный: беспозвоночных беспозвоночным
хордовые: хордовые
составлявшим: составлявшим
трехмерный: трехмерный
отсутствие: отсутствия
исправление: исправления
верхний: верхняя верхней
смещение: смещения
ранее: ранее
костный: костного
правый: правого
возвращение: возвращение
играть: играло играли
дермальными: дермальными
исследование: исследовании
бока: бока
гребень: гребня
гипотеза: гипотезе гипотезы гипотеза гипотез
случай: случае
укус: укуса
музей: музея
позволять: позволяет
ясность: ясности
аналог: аналогов
рот: рот рту рта ртом
собственный: собственно
консенсус: консенсуса
хищническом: хищническом
приспособленный: приспособленный
часть: часть
рисунок: рисунок
орган: органы
работа: работы
фильтрация: фильтрации фильтрацией
став: став
панцирем: панцирем
внутри: внутри
процеживать: процеживали
оболочников: оболочников
являться: являются является
бесчелюстных: бесчелюстных
левый: левого
затруднять: затрудняет затрудняли
устройство: устройства
активный: активными активных активного активному
подвижность: подвижности подвижность
застрявших: застрявших
состоять: состоит
разнообразие: разнообразие
раскрытый: раскрытым
разный: разному
тип: типа типом
низший: низших
центр: центре
вращаться: вращаться
создана: создана
строение: строения строение
основание: основание основании
очередь: очередь
модель: модель модели
предполагающие: предполагающие
чувство: чувств
способ: способы способов
сильный: сильного сильно
четвертым: четвертым
постулировать: постулируют
противопоставляя: противопоставляя
относительный: относительно
ордовика: ордовика
интерпретация: интерпретации
путать: путать
полученная: полученная
годы: годы
эволюция: эволюцией эволюции эволюцию
мнение: мнению
черепно: черепно
фильтратором: фильтратором
дать: дала
автор: авторы авторов
обеспечивая: обеспечивая
обычный: обычное обычного
иметь: имеют
вещество: вещества
длинный: длинный
голова: головы
мозг: мозг
луч: лучей
некоторые: некоторые
хордовых: хордовых
способность: способность
одна: одна
дополнительный: дополнительных
угол: угол
представление: представления
смыкания: смыкания
миксинами: миксинами
фото: фото
известный: известно
плохой: плохо плохим
нерв: нервы
питающихся: питающихся
статья: статьи статье статья
щель: щелей
пригодность: пригодность
требовать: требует
птераспидного: птераспидного
сопровождаться: сопровождался
былой: былого
журнал: журнале
вероятный: вероятно
ограниченный: ограниченные ограниченных
сложиться: сложиться
сторона: сторону
макрофагами: макрофагами
фильтрующего: фильтрующего
источник: источник
получать: получают
головной: головной
основа: основой основе
весомый: весомый
унаследованным: унаследованным
третий: третьи
тяжелейший: тяжелейшая
научный: научная
панцирь: панцирь
ранний: ранние ранних ранним ранней
используя: используя
сверху: сверху
редкий: реже
челюсть: челюстей челюстью
порода: породы
ученых: ученых
прижизненный: прижизненном
водоема: водоема
создает: создает
зенкенбергского: зенкенбергского
положение: положении положение положения
специальный: специальными
зародиться: зародился
шумовская: шумовская
основанный: основаны
изучен: изучен
современный: современных
алгоритм: алгоритмами
напомнить: напомню
спереди: спереди
линия: линии
отличие: отличие
бесчелюстным: бесчелюстным
элемент: элементов элементами элементы
первый: первую
питание: питания питание питании
предложенные: предложенные
фильтрационное: фильтрационное
преуспеть: преуспели преуспеть
день: дня
получить: получить получили
изображение: изображение изображения
сравнение: сравнение сравнений
изучение: изучение
формируют: формируют
такой: такого таком таким
регулировать: регулировать
размер: размер
друг: друг друга
возможный: возможные возможны
число: числе
сочленение: сочленения
прехордальной: прехордальной
проблема: проблему
использовать: использовали
обработана: обработана
раскрытие: раскрытию раскрытие раскрытии раскрытия
похожий: похожих
идея: идея
возникшие: возникшие
питаться: питались
скан: скан
разнощитковые: разнощитковые
изолированный: изолированных изолированными
крупный: крупный крупными
подвешены: подвешены
заключать: заключают
новый: новой новом новые
совок: совок
обсуждаемая: обсуждаемая
отдельный: отдельных
изменение: изменениями
щит: щит
крепиться: крепились
рострум: рострум
помощь: помощью помощи
добиться: добиться
состояние: состояние
продолжать: продолжает
фильтрующая: фильтрующая
четвертые: четвертые
окаменелость: окаменелости
сохранившегося: сохранившегося
ученые: ученые
смоделировать: смоделировали
материал: материалов
рентгеновский: рентгеновской рентгеновских
живой: живых
вариант: варианты вариантом
остальное: остальные
делить: делила
хищничеству: хищничеству
питательный: питательные
план: план
разгадать: разгадать
конец: конец
входить: входит
независимый: независимо
показывать: показывает
карла: карла
структура: структуры структуру структур
осадок: осадок
деформация: деформаций
конодонтами: конодонтами
птераспид: птераспид
картинка: картинку
совокупность: совокупность
пищевой: пищевых
относить: относят
мягкий: мягких
поддерживать: поддерживают
риноптерасписа: риноптерасписа
обработка: обработки
кусающая: кусающая
дело: деле
резать: резать
представитель: представителей
вмещающей: вмещающей
поперечный: поперечных
боковыми: боковыми
прикрепляться: прикреплялись
расширять: расширять расширяли
аппарат: аппарата аппарат аппаратов аппаратом
весьма: весьма
вытекать: вытекают
бесчелюстными: бесчелюстными
возникновение: возникновения
плакод: плакод
порасписа: порасписа
сечение: сечений
область: области
позволяя: позволяя
оси: оси
скребущая: скребущая
расположенный: расположенной
миксин: миксин
новообразование: новообразованиями
художественный: художественная
трехмерная: трехмерная
череп: череп
расположение: расположения расположение
хорда: хорда
закрытие: закрытие закрытии закрытия
ткань: тканей тканях
предок: предков предка
взаимный: взаимное
возможность: возможность возможности
рыба: рыб
окклюзия: окклюзии окклюзия
бесчерепных: бесчерепных
вместе: вместе
наружный: наружный
загадка: загадок
способствовать: способствовало способствует
субстрат: субстрат
передний: передней
хищничество: хищничество
очищение: очищению
насчет: насчет
ограничиваться: ограничивалась
интерпретировать: интерпретируют
название: названия
отверстие: отверстие
закрытый: закрытым
разнообразный: разнообразное
вовсе: вовсе
вверху: вверху
палеонтолог: палеонтологи
считаться: считается
никакой: никаких
снижать: снижает
тенденция: тенденцией
девонский: девонского
минога: миноги миногами
оставаться: остаются оставался
образ: образом
основный: основными
среди: среди
отфильтровывали: отфильтровывали
изнутри: изнутри
экология: экология
внешний: внешнего внешне
поступающих: поступающих
остается: остается
детритофагом: детритофагом
появиться: появилась
модифицироваться: модифицироваться
нарушая: нарушая
стратегия: стратегий
приспособлен: приспособлен
ганса: ганса
различный: различные различных
тонкий: тонких
брюхо: брюха
установить: установили
дно: дна
извлекать: извлекать
следовать: следует
одни: одни
открытие: открытие
группа: группа группе группы
зубной: зубные зубных зубными
точнее: точнее
большой: большом
правильный: правильно
листок: листком листок
след: следов
скелет: скелет скелета
мочь: могли
вращением: вращением
вперед: вперед
компьютерный: компьютерной
поскольку: поскольку
исключение: исключением
прямой: прямым
появление: появлением
мозговые: мозговые
сложный: сложные
трехмерное: трехмерное
противоречить: противоречит
аргумент: аргумент
середина: середины
оценить: оценить
тело: тело тела
анатомия: анатомии
собираться: собираются
нервный: нервного
экологический: экологических
пластинчатый: пластинчатым
доходить: доходят
прохождение: прохождению
хордовым: хордовым
соответственный: соответственно
морфология: морфологии
гетеростраки: гетеростраки
граница: границы
зачерпывания: зачерпывания
утверждая: утверждая
позвоночный: позвоночные позвоночных позвоночным
пластинка: пластинками пластинок пластинки пластинке пластинка
микротомографии: микротомографии
определить: определили
номер: номер
подвижный: подвижными подвижны
частить: части
внутренний: внутренней
подходящий: подходящим
спор: споров
исключать: исключает
предполагаться: предполагается
напоминать: напоминали
двигаться: двигаться
остаться: остались
сайт: сайта
представлять: представляет
риноптераспису: риноптераспису
черепитчатый: черепитчатую
невозможный: невозможно
гетерострака: гетерострака
иметься: имелись
проникающую: проникающую
пищать: пищи
центральный: центральных
макрофагальном: макрофагальном
больший: большая
пытаться: пытаются
объект: объекта объекты объектами
макрофагии: макрофагии
видимый: видим
экземпляр: экземпляра экземпляр
какой: какую
целостность: целостность
глена: глена
хищничества: хищничества
сохраниться: сохранился
