ребер: ребер
лапа: лапа лапы
пример: примеру
принадлежать: принадлежит принадлежат
связь: связи
позднепермской: позднепермской
частность: частности
признак: признаки
результат: результаты
понять: пойму
сохраниться: сохранилась сохранился
примерно: примерно
утонченными: утонченными
состояние: состоянии
парк: парк
анна: анна
сухой: суше сухим
весь: всей
минимальный: минимальный
подводя: подводя
рептилия: рептилии
добыча: добычей
разнообразия: разнообразия
искать: искать
полученные: полученные
центр: центров центрах
полярность: полярность
нос: носа
ученые: ученые
крутой: круто крутой
встречаться: встречаться встречаются
автор: авторы
речной: речную
пермский: пермского пермскому пермские пермском
хищный: хищных хищные
пойма: пойме
казеиды: казеиды
видео: видео
амфибиями: амфибиями
видный: видно
раннепермских: раннепермских
тетрапод: тетрапод
задолго: задолго
загадочный: загадочное
близкий: ближе близок близких
европейский: европейской
уникальный: уникальные
триасового: триасового
позволявшими: позволявшими
первый: первых первой первые первыми
пеликозавры: пеликозавры
прогрессивный: прогрессивные прогрессивным
оценивается: оценивается
берег: берегов
внимание: внимание
наземный: наземными наземных
десяток: десятки
раннепермского: раннепермского
день: дня
сообщество: сообществах
африканский: африканского
каменноугольный: каменноугольного
вызванный: вызвано вызваны
сам: самое
явный: явно
палеогеографически: палеогеографически
течение: течение
обнаружить: обнаружили
датированных: датированных
костя: кости костей
сожаление: сожалению
необходимость: необходимости
привести: привело
сша: сша
иностранцевия: иностранцевия
раннепермские: раннепермские
позвонок: позвонков позвонок
помимо: помимо
ареал: ареалами
вероятный: вероятно
живший: живший
биармозух: биармозух
ихнокомплексах: ихнокомплексах
звероящеры: звероящеры
реконструкция: реконструкция
изогнутый: изогнутая изогнутые изогнутую
современный: современными современного
заклыковых: заклыковых
таксонов: таксонов
который: которое которым
мелкий: мелкий мелкие
самый: самым самые самых самый
прямой: прямой
обнаружено: обнаружено
клиновидный: клиновидной
начало: началу начале
теплокровный: теплокровными теплокровных
рисунок: рисунок рисунке
парус: парусом
киаманскому: киаманскому
последний: последний последнего последним
любопытный: любопытен
неизвестный: неизвестен
некрупный: некрупный некрупного некрупными
анализ: анализ
горгонопсом: горгонопсом
торчать: торчали
поскольку: поскольку
бедренный: бедренная бедренную
пеликозавров: пеликозавров
отнести: отнести
горгонопсов: горгонопсов
обсуждаемой: обсуждаемой
раннепермскими: раннепермскими
солидный: солидный
определен: определен
источник: источник
располагающихся: располагающихся
древнейший: древнейший древнейших древнейшего древнейшими
базальному: базальному
служить: служить
итог: итоге итоги
германий: германии
фото: фото
жила: жил
южноафриканская: южноафриканская
древний: древний
обнаружены: обнаружены
скакать: скакать
уровень: уровня
рараниму: рараниму
вздутый: вздуты
сегодняшний: сегодняшний
пищать: пищу
прорисовка: прорисовка прорисовки
число: числе
завроктон: завроктон
теплыми: теплыми
млекопитающий: млекопитающих млекопитающими
животное: животное животные животными животных животного
длинный: длиннее
отдел: отдела
широта: широтах
развитие: развитие
выбор: выбором
хищник: хищник хищникам хищниками хищники
сочетаться: сочетаются
типичный: типичные
естественный: естественной
выдвинутую: выдвинутую
позвоночный: позвоночными позвоночных
произойти: произошли произошло
америка: америке
приуральского: приуральского
конец: конца конце
ранее: ранее
средний: среднему средней
терапсидных: терапсидных
граница: границей границе
отросток: отросток отростками отростки отростков
морфологический: морфологическим
напоминать: напоминал
китай: китае
доминировать: доминировали
рубиджеинам: рубиджеинам
горыныч: горыныч
переслать: перешли
звероящерами: звероящерами
область: областях
антеозавров: антеозавров
головка: головкой
постановка: постановка
судя: судя
очередь: очередь
обратить: обратите
элемент: элементы
установление: установлении
ночница: ночница
костеносный: костеносный
статья: статьи
линия: линии
музей: музее
появление: появлению появления
казеид: казеид
отложение: отложений отложения отложениях
строение: строением строении строения строение строению
точный: точный
ящерица: ящериц ящерицы
разгонять: разгонять
рис: рис
ящероподобными: ящероподобными
располагаться: располагается располагалась
занять: заняли
боков: боков
триаса: триаса
однозначный: однозначно
набор: наборы
согласный: согласно
зуб: зубов зубами
терапсидами: терапсидами
длина: длина
слой: слоя слои слой слоях
радиация: радиации
прояснить: прояснить
рараним: рараним
характерный: характерен характерны характерные характерной
разделение: разделение разделения
горгонопса: горгонопса
осушение: осушением
сезон: сезонами
пробел: пробел
третий: третьих
майорка: майорка
вообще: вообще
иметь: имело
палеошироты: палеошироты
примитивный: примитивной примитивными примитивных примитивным примитивные
вовсе: вовсе
богатый: богатые
звероящер: звероящер
горгонопс: горгонопс
считать: считали
какой: какие
весьма: весьма
обусловленный: обусловлено
необычный: необычное
терапсиду: терапсиду
синапсид: синапсид
метр: метр метров
возраст: возраст возраста
челюсть: челюсти
исследователь: исследователей исследователи
расположенный: расположенных
бурный: бурное
пола: поле
богданова: богданова
окаменелость: окаменелостей окаменелости
дополнительный: дополнительные
след: следы следов
похожий: похожие
вещество: веществ
пеликозаврами: пеликозаврами
миланском: миланском
перми: перми
сайт: сайта
никакой: никаких
теплокровности: теплокровности
составлять: составляли
черта: черт черты чертам чертой
форма: формой форме
выделение: выделение
пар: пара
новиковская: новиковская
динозавр: динозавров
пеликозаврам: пеликозаврам
ближайший: ближайших
ихнотаксон: ихнотаксон
местонахождение: местонахождение
место: месте место мест
называть: называют
кость: кость костями
разнообразие: разнообразие
найденного: найденного
смещенной: смещенной
ученых: ученых
загнутый: загнутыми
короткий: короткий
малоберцовой: малоберцовой
предполагаемый: предполагаемый
предоставить: предоставили
нынешний: нынешнего
фауна: фауны фауна
выраженными: выраженными
африка: африке африки
четвертых: четвертых
симфиз: симфиз
майорки: майорки
продолжаться: продолжался
единственный: единственный
окружающий: окружающими
пангеи: пангеи
больший: большим
сильный: сильно
четырьмя: четырьмя
сходство: сходством
выделить: выделить
эпоха: эпохи
сабельный: сабельный
обнаруженных: обнаруженных
средне: средне
ставить: ставит
мочь: могли
территория: территории
регион: регионами регионах
продвинутый: продвинутая
пыльца: пыльцы
доказательство: доказательства
клад: клады клад
высокий: высокие
фотография: фотография фотографии
номер: номером
ранний: раннего ранней ранних ранними раннем
поиск: поиска
обратный: обратному обратную обратного
позднепермские: позднепермские
международный: международная
минимум: минимум
призрачный: призрачном
заметный: заметно
отдельный: отдельные
ряд: ряд
второй: вторых
европа: европе
остров: острове
крайний: крайнюю
новый: новые
запад: западе
неопределенному: неопределенному
поперечный: поперечными поперечные
обнаружение: обнаружении
саблезубый: саблезубый саблезубому
зона: зоне зон
сардинии: сардинии
растительноядные: растительноядные
снизиться: снизилось
долгий: долгое
биармозухий: биармозухий
отсутствовать: отсутствует отсутствуют
обнаруженный: обнаруженный
старинка: старинке
слитный: слитный
вестибулярного: вестибулярного
происхождение: происхождение происхождения
некоторые: некоторые некоторых некоторым
диастема: диастема
ловкий: ловкими
педра: педра
яркий: ярко
туловище: туловище
метаболизма: метаболизма
чье: чье
неполнота: неполнотой
продолжающимся: продолжающимся
техас: техаса
заклыковый: заклыковый
южный: южной
окутано: окутано
суперхрона: суперхрона
водоемами: водоемами
терапсиды: терапсиды
среди: среди
зазубренный: зазубренный
различимый: различимая
большеберцовой: большеберцовой
высокоширотных: высокоширотных
мезозоя: мезозоя
собака: собаку
позволять: позволяет позволяют
ископаемый: ископаемой
молодой: моложе молодых молодой
находить: находили
муниципалитет: муниципалитете
крыловидный: крыловидный
лиценопса: лиценопса
бассейн: бассейнах
климатический: климатическая
скорый: скорее
нужный: нужных
случай: случае
неплохой: неплохо
например: например
порода: породы
сохранить: сохранил
родственник: родственников
синапсиды: синапсиды
сохранившихся: сохранившихся
оставляя: оставляя
группа: группа группы групп
часть: часть
представленный: представлены
существовать: существовали существовала
активный: активными активной
предполагать: предполагает предполагают
очёрская: очёрская
несомненный: несомненным
сближать: сближают
относиться: относится относятся
семейство: семейство
указывать: указывают
большеберцовая: большеберцовая
восточный: восточной
основный: основном основные основных
продвинуть: продвинут
считающаяся: считающаяся
предок: предки предков
костный: костного
сестринский: сестринские
вдобавок: вдобавок
возникнуть: возникли
поздний: позднего
тетрацератопс: тетрацератопс
консерватизм: консерватизмом
видеть: видеть
колено: колени
галоп: галопом
смочь: сможет смогли
походить: походил походит
малоберцовая: малоберцовая
суперхрону: суперхрону
майорке: майорке
конечность: конечностей конечности
находиться: находились находится
обитание: обитания
дело: деле
фрагментированность: фрагментированность
ас: асе
рост: рост ростом
терапсидом: терапсидом
жить: жило
отвергать: отвергает
наступление: наступлением
значительный: значительно значительную значительная
стволовой: стволовых
отличающийся: отличающиеся
синапсидами: синапсидами
причем: причем
верхний: верхний верхней
показать: показал
данные: данных данным
вопрос: вопрос
остаток: остатки остатками
ихнотаксоны: ихнотаксоны
вышележащей: вышележащей
экватор: экватору
испания: испании
найти: нашли
таксоны: таксоны
большой: большой
пища: пищей
умеренный: умеренных умеренного
передний: передняя переднюю передними передние
звероящеров: звероящеров
особь: особи
определить: определить
пунктир: пунктир
подвернуты: подвернуты
доминирующий: доминирующими доминирующим
представитель: представителя представитель представителей представителю представители представителями
такой: таком такими
вятка: вятки
представлять: представляла
капториниды: капториниды
стать: стали
отсутствие: отсутствии
промежуточный: промежуточным
нижний: нижних нижней
антеозавры: антеозавры
дмитрия: дмитрия
род: род
уцелеть: уцелели
установленный: установлено
временный: временной временными
существовавших: существовавших
экваториальный: экваториальной экваториальных экваториальное
условие: условиями
назвать: назвать
звено: звеном
индивид: индивида
ихнороды: ихнороды
четвероногий: четвероногие
прижизненный: прижизненный
относительный: относительно
размер: размером
россия: россии
прочее: прочего
терапсид: терапсид
древние: древними древним
горгонопсами: горгонопсами
центральный: центральном центральной
известный: известны известных известными
левый: левая
исключая: исключая
слабый: слабо
экспансия: экспансией
настоящий: настоящей
конечный: конечном конечных
каталог: каталог
киаманского: киаманского
средиземноморья: средиземноморья
образец: образец
оранжевый: оранжевый
эрифостома: эрифостома
силуэт: силуэт
объяснение: объяснением
найдены: найдены
растительный: растительную
находка: находка
сторона: стороны
старейший: старейший
череп: череп черепа
освоить: освоили
зазор: зазор
сложность: сложности
скелет: скелета скелет скелету
сжатый: сжатый
формация: формации
возможный: возможно
крупный: крупные крупный крупных
летопись: летописи
баньяльбуфар: баньяльбуфар
другой: другими другого
обитать: обитал обитали
резкий: резко
тайный: тайны
среднепермских: среднепермских
базальным: базальным
эннатозавр: эннатозавр
исключить: исключить
относить: относят
возможность: возможностью
задний: задних задняя задними задние
отличаться: отличались
история: истории
разный: разными
способ: способами
разрез: разреза разрезе
проведенный: проведенный
филогенетический: филогенетический
горгонопсам: горгонопсам
извлечены: извлечены
откуда: откуда
магнитостратиграфический: магнитостратиграфический
убийца: убийца
заявить: заявила
полностью: полностью
крокодил: крокодил
одним: одним
крыловидных: крыловидных
азия: азии
муссонный: муссонный
вид: виды вида
картинка: картинку
нёбо: нёба
важный: важных
независимый: независимо
северный: северной
частить: части
пространственный: пространственно
наклоненный: наклоненный
заклыковая: заклыковая
описать: описала
лисица: лисицу
подтвердить: подтвердили
клык: клык
существование: существование
несмотря: несмотря
исключено: исключено
испанский: испанском
целый: целом
карта: карта
красный: красный
следовать: следует
палеонтологический: палеонтологической
магнитный: магнитное
основание: основании
хвост: хвоста
внести: внесли
гипотеза: гипотезу
полувыпрямленные: полувыпрямленные
бродить: бродили
среднепермского: среднепермского
найденные: найденные
подводить: подводить
климат: климата климат
зубной: зубной
обмен: обмен
половина: половине
период: периода периоду периоде
нижнечелюстной: нижнечелюстной
местность: местность
аппарат: аппарата
влажный: влажным
мрак: мраком
считаться: считается считалось
