мигрировать: мигрируют
высокий: высоких высокую
подсчета: подсчета
расчета: расчета
вероятность: вероятности вероятностью
обработано: обработано
сделанных: сделанных
океан: океана океану океане
наблюдавшихся: наблюдавшихся
известный: известно
уровень: уровня
отлов: отлове
возраст: возрасте
гавайских: гавайских
влиять: влияет
климат: климата
пароход: пароход
сезон: сезона
большой: большом большого большое
точный: точных
фотографировать: фотографируй фотографируют фотографирует фотографировать
какой: какие каких каким
сконцентрировать: сконцентрировать
например: например
сравнение: сравнению сравнение
сообщавших: сообщавших
метода: метод
насколько: насколько
аномальный: аномально
теплая: теплая
деталь: деталях
десятилетие: десятилетия десятилетие
огромный: огромная
проводить: проводят
нитка: нитке
количество: количество количествах количества
дистанционный: дистанционно
организоваться: организуются
многие: многие многих
материк: материки
параметр: параметры
жизнь: жизни
избежать: избежать
угодный: угодно
минеральный: минеральными
пищевой: пищевой
куст: кустам
разбор: разбора
координаты: координаты
хребет: хребтами
свой: своим
возможность: возможность
пресс: прессе
массовый: массовой массовая
вид: видов
перемешиваться: перемешиваются перемешиваться
модель: моделей модели
отметина: отметин
тепло: тепла
распространяться: распространялся
область: область области
обитать: обитает
эффективный: эффективные эффективный
приведены: приведены
красный: красный
входить: входят
временный: временным
крупный: крупных крупными
годах: годах
использовать: используют
влага: влаги
прослеживать: прослеживали
происходить: происходит
образ: образом
царапина: царапин царапины
несет: несет
мониторинг: мониторинга
длина: длина
среднемесячный: среднемесячная
экосистемных: экосистемных
численность: численность численности численностей
восстановление: восстановлении
точка: точках
широта: широт
задача: задача
явление: явления
вещество: веществами
активный: активного активно
вспять: вспять
сложный: сложна сложно сложны сложная
гавайях: гавайях
необходимый: необходимыми
рыба: рыбы рыб
допромысловых: допромысловых
полушарие: полушарие
предложить: предложить
качество: качестве
равный: равно равной
решать: решают
польза: пользу
длиннокрылый: длиннокрылый
целый: целом целой целая
отпустить: отпустить
послужить: послужить послужили
девяти: девяти
сложнее: сложнее
теплой: теплой
граница: границ
строить: строй строить
дальний: дальний
демографических: демографических
вызывая: вызывая
знакомая: знакомые
аномалия: аномалии аномалия
расчет: расчет
снижаться: снижаться
ранний: ранних
автор: авторы
характеристика: характеристик
погибший: погибших
животное: животных
сложность: сложностей
следуя: следуя
репрезентативную: репрезентативную
ситуация: ситуаций
индивидуальный: индивидуальный
рисунок: рисунок
сам: самое
снижать: снижать
море: моря море
участвовать: участвовало
тропический: тропических
способный: способных способны
правда: правда
колония: колониях
любитель: любителями
бассейн: бассейн
мировой: мирового мировому
самка: самки самок
температурный: температурная
экспедиция: экспедиция
подъема: подъема
экосистема: экосистем экосистемы
держаться: держатся
первичный: первичного
получиться: получилось
спутниковый: спутниковыми
знать: знать
последний: последних
цикл: цикла цикл циклов
ниньо: ниньо
благополучие: благополучия
множество: множество
маршрут: маршрутов маршрута
существовать: существует
миграционный: миграционных
экватор: экватора
ладонь: ладони
научный: научная научным научных
построение: построении
ведется: ведется
кормовой: кормовая кормовой кормового
аравийский: аравийского
восточный: восточного
небольшой: небольшой небольших небольшом
бессмысленный: бессмысленно
пометить: пометить
главный: главный
глейшер: глейшер
ольга: ольга
карта: карта
годы: годы
перелом: перелом
среди: среди
иметься: имеется
заметный: заметная
прозвать: прозвали
способ: способ
формирование: формирования формировании
число: числа число числе
метить: метить
фитопланктона: фитопланктона
ожидалось: ожидалось
попасться: попалось
видный: видны
налаживание: налаживании
тихий: тихого
проба: пробы
пастись: пасутся
учитывать: учитывать
возможный: возможные возможно
состав: состав
исключить: исключить
емкость: емкость
кит: кита киты китов китами кит китам
регион: регионе регион
нейросеть: нейросеть
потепление: потепления
вода: воды водах
североатлантический: североатлантический
труднодоступный: труднодоступны
вручную: вручную
зимовка: зимовок
ходить: ходит
слой: слоя
меря: мере
сидеть: сидят
демографические: демографические
угроза: угрозой
источник: источник
встает: встает
отслеживание: отслеживание
реальный: реальном
получившая: получившая
развитие: развития
доступный: доступна
частность: частности
географические: географические
отмечать: отмечают
изображение: изображение
умолчание: умолчанию
простой: простые
апвеллингов: апвеллингов
время: времена
распространены: распространены
расти: росла
пролив: проливе
общий: общий общая общих
уникальный: уникальных
весь: всей
старый: старый
отслеживании: отслеживании
химический: химический
пошел: пошел
картина: картина картины
подходить: подходит
найти: найти
перемещаться: перемещаются
фиксация: фиксации
объединение: объединения
вдоль: вдоль
значение: значений значения
стать: стали стала
грань: грань
продолжить: продолжила
тихоокеанский: тихоокеанская
апвеллинги: апвеллинги
калифорнийских: калифорнийских
видимый: видимому
прыжок: прыжок
быстрый: быстро быстрые быстром
править: правило
кормежку: кормежку
массы: массы
значительный: значительно
перемещение: перемещений перемещение перемещениях
преобладающий: преобладающих
поэтому: поэтому
сеть: сетью сети
интересующий: интересующий
амплитуда: амплитуда
связанный: связанных
эффектный: эффектный
поставиться: поставило
помеченных: помеченных
объединить: объединить
сработать: сработать
восстанавливаться: восстанавливаются
четко: четко
тот: той
изменение: изменении изменениями изменения
пищать: пищи
парк: парк
растет: растет
выкармливающих: выкармливающих
планктоноядной: планктоноядной
осуществляться: осуществляется
аренда: аренда
убедить: убедить
элемент: элементы
субтропический: субтропических
непростой: непростое непросто
акустический: акустические
основа: основой
морской: морских
истребление: истребление
размышление: размышления
таки: таки
прибрежный: прибрежные
обеспечивающие: обеспечивающие
берингова: берингова
черта: чертах
исчезновение: исчезновения исчезновение
записывать: записывай
договоренностей: договоренностей
контекст: контексте
давать: дают
экскурсия: экскурсии
немигрирующая: немигрирующая
получать: получать
банк: банка
видеть: видели
мексика: мексики мексике
связывать: связывают
существовавшая: существовавшая
отдельный: отдельные отдельных отдельными отдельно отдельная
очевидный: очевидна
местный: местных
сесть: сесть
любой: любого
попалить: попали
предусмотрено: предусмотрено
рассчитанный: рассчитана
взаимодействие: взаимодействие взаимодействий
залив: залива
смочь: сможет смогли
ареал: ареал
проблема: проблему проблемы
пионер: пионер
горизонтальный: горизонтальной
отмечаться: отмечалось
перестройка: перестроек
сотня: сотен
нагульных: нагульных
расходиться: расходятся
больший: большую
белая: белых
заниматься: занималась
система: система
достигнуть: достигнуть достигла
горбач: горбачей горбач горбачи
разница: разницей
проверить: проверить
глобальный: глобальные глобальными
парка: парке
закономерный: закономерные
среднемноголетних: среднемноголетних
частить: части
передатчик: передатчиками
удаленными: удаленными
идентификация: идентификации
каталог: каталогов
уменьшение: уменьшения
отклонение: отклонений отклонение
каскад: каскад
емкости: емкости
введение: введения
организация: организации
объект: объекты
двадцатилетний: двадцатилетнего
желающего: желающего
турист: туристы
попадать: попадать
происходящий: происходящий
благодаря: благодаря
несколькими: несколькими
неодинаковый: неодинакова
день: дня
получаемые: получаемые
колумбия: колумбии
популяционных: популяционных
платформа: платформы
который: которое которыми которую
спина: спину
инструмент: инструмент
наблюдаться: наблюдается наблюдался наблюдалось наблюдаются
сформировалась: сформировалась
горный: горными
ближайший: ближайшие
южный: южного
британский: британской
место: местами месте места местах место
поверхность: поверхности
совместный: совместном
напрягаться: напрягаться
использование: использования
широкий: широкой
трудозатратно: трудозатратно
взяты: взяты
публикация: публикаций
истощенных: истощенных
богатый: богатой
одним: одним
посещать: посещает
информация: информации
миро: миру
декадная: декадная
представлять: представляет представлять
второй: втором
млекопитающий: млекопитающих
изучение: изучения
дорогой: дорого дорогое
иметь: имеет
конкретно: конкретно
обнаруживать: обнаруживали
атмосфера: атмосферы
накладываться: накладываться
исключение: исключением
судовые: судовые
бороздить: бороздить
многочасовой: многочасового
остановка: остановка
лев: львов
серый: серых серые
выяснение: выяснение
показать: показал
разделять: разделяют
рассматривать: рассматривать
провиснув: провиснув
вертикальный: вертикальной
черный: черный
бей: бей
холостовали: холостовали
пойти: пойти
средний: средних средним
удовольствие: удовольствие удовольствием
поведение: поведения поведении
сила: силы
четких: четких
особь: особей
другой: другими другом
простор: просторы
ранее: ранее
вперед: вперед
перераспределение: перераспределения перераспределение
снизиться: снизилась
горбатый: горбатого горбатые горбатых горбаты
замедлился: замедлился
писать: писали
дополнительный: дополнительной
летний: летнего летних
побережье: побережья
остров: островов островах острова
юг: юга
компонент: компонентов
ресурс: ресурсов ресурсы
такой: таких таким
коллега: коллегами
учетом: учетом
прийти: пришли
выходить: выходило выходи
поток: поток
оценка: оценки оценка оценок
исследователь: исследователей исследователям
факт: факт
наоборот: наоборот
варварский: варварское
охранный: охранные
метка: меткам метками
май: мае
выжить: выжили
район: районах районов районами районы района районе район
набор: набор
пятно: пятен пятна
материковый: материковой
мнение: мнение
сократиться: сократилась
помечена: помечена
прикинуть: прикинуть
опираясь: опираясь
сторона: стороне
важнейший: важнейшими
зоолог: зоологами
проект: проекте проекты
предшественник: предшественников
стратегия: стратегии
отследить: отследить
дротик: дротиками
основанный: основан
наблюдение: наблюдений наблюдения наблюдениям
участник: участниками
начинать: начинают
произвести: произвести
вашего: вашего
размер: размер
являться: являются
аляски: аляски
вернуться: вернулись вернутся
стабильный: стабильной
возникать: возникать
природоохранные: природоохранные
цвет: цвет цветом
встреча: встреч встречах
покрывать: покрывать
проблематично: проблематично
данные: данных данные
динамика: динамикой динамику
выйти: вышло
промысел: промысел промысла
разный: разных разными
ниша: ниши
результат: результаты
строиться: строятся
ежемесячных: ежемесячных
друг: друг друга
крайний: крайней
фотографами: фотографами
соседний: соседние
шрам: шрамов
дата: дата
нарастать: нарастала
остановить: остановила
конкурировать: конкурировать
истощение: истощения
кормиться: кормятся кормиться
показываться: показываются
взрослый: взрослые
восток: востоке
длительный: длительная
переместиться: переместились
снимок: снимков снимках
северотихоокеанский: северотихоокеанский
одном: одном
стартовать: стартовала
оказаться: оказалось оказаться
анализ: анализ
географических: географических
закрытый: закрытую
криля: криля
механизм: механизмов
гораздо: гораздо
обсуждаемой: обсуждаемой
стреляя: стреляя
смоделировать: смоделировать
уходить: уходят
факторов: факторов
популяция: популяция популяций популяции популяцию
зрение: зрения
порхать: порхают
означать: означает
сравнивать: сравнивает
моделирование: моделирования
картинка: картинку
должный: должны
размножение: размножения
некоторый: некоторое некоторой
выход: выход
условие: условий условия
название: название
будущий: будущее
рост: рост роста
полный: полной
судный: судна
объектив: объектив
национальный: национальном национальный
поверхностный: поверхностного
водный: водная водной
океанологический: океанологические
получить: получить
хитрый: хитрый
показатель: показатели
архив: архивы
зимовать: зимуют
зоопланктон: зоопланктона
век: века
смертность: смертность смертности
необычайный: необычайно
изучаемом: изучаемом
резкий: резкое резко
одни: одни
единица: единицы
густой: густой
предыдущий: предыдущих предыдущим
некоторые: некоторых
продуктивность: продуктивность продуктивности
первый: первое
фактором: фактором
синхронный: синхронное
редкий: реже
глубина: глубин
холодный: холодной
увеличиваться: увеличивалась увеличиваться
выяснить: выяснить
нескольких: нескольких
штормовых: штормовых
зимний: зимних зимнего
изобрести: изобрели
начало: начале
рождаемость: рождаемости рождаемость
свободный: свободно
зима: зиму зимы
индивидуально: индивидуально
трансектами: трансектами
фото: фото
климатический: климатические климатическими климатических
относительный: относительно относительную
нора: норах
нижний: нижней
самый: самый самая
верхний: верхнего
одновременный: одновременно
китообразный: китообразных
запутанный: запутанная
отнести: отнести
бесконечный: бесконечный
осцилляция: осцилляция
период: период периода
посчитать: посчитать посчитали
правильный: правильно
произойти: произошло
либо: либо
фотография: фотография фотографий фотографии
фотоидентификация: фотоидентификация
связь: связь
исследование: исследований исследования исследовании
новый: новых новой
отсутствие: отсутствие
сильный: сильно сильнее сильного
включив: включив
рейс: рейс
естественный: естественные
единственный: единственная
сайт: сайта сайте
качественно: качественно
показано: показано
северный: северной
смысл: смысл
опознаваемых: опознаваемых
вообще: вообще
собирать: собирать
иначе: иначе
снижение: снижение снижении
основный: основном основным основная
позволять: позволяют
мауи: мауи
сочетание: сочетания
поймать: поймать
оси: оси
представленный: представленных
течение: течений течения
темп: темпы темпов
работа: работами работе
задействовано: задействовано
детенышей: детенышей
каждый: каждом каждого
нагул: нагула
сравнивавших: сравнивавших
примерно: примерно
тревожный: тревожных
циклический: циклические
колебание: колебания
периодичность: периодичностью
неизменный: неизменный
присутствовать: присутствовали
неизвестный: неизвестно неизвестном
прирост: прирост
опыт: опыт
двадцати: двадцати
мелкий: мелкой
мораторий: моратория
учеты: учеты
оценивать: оценивать
база: база базе
начать: начать
сведение: сведения
пришедшими: пришедшими
хвост: хвоста хвостов
протяжение: протяжении
проследить: проследить
птица: птиц
оптимистичный: оптимистичные
тропик: тропиках
трофического: трофического
изучаемой: изучаемой
успешный: успешнее
создание: создания
отловить: отловить
наличие: наличием
считать: считают
делаться: делается
группа: группа группам групп
мотивация: мотивацией
общественный: общественных
коммерческий: коммерческий коммерческого
понимать: понимать
удалось: удалось
сразу: сразу
холостующие: холостующие
опознанный: опознанных
врезка: врезке
присутствие: присутствия
линия: линия линий
пола: поле
северо: северо
вновь: вновь
перемена: переменами
калифорний: калифорнии
повторяться: повторяться
ручного: ручного
ощутимый: ощутимый
столько: столько
следовательно: следовательно
выраженное: выраженное
экологический: экологической
генетик: генетика
сбежать: сбегут
дело: делам дело
пойманные: пойманные
сбор: сбора
бывалый: бывал
подводный: подводными
берег: берегов берега
статья: статей статьи
статус: статусы статусах
показана: показана
титова: титова
случай: случае
подсчеты: подсчеты
учета: учета
практически: практически
пища: пища
китобойный: китобойного
годов: годов
масса: масса
температура: температур температура
заставить: заставили
направление: направлением
многолетний: многолетнего многолетним
выброс: выбросы
избавить: избавит
плавный: плавно
лето: летом
структурировать: структурировать
аляске: аляске
эль: эль
признак: признаки
хищник: хищников
считаться: считаются
ученые: ученые
