аспект: аспектов аспектами
несопоставимо: несопоставимо
обезьяна: обезьянами обезьян
ученых: ученых
друг: друг
мочь: могло могли
число: числе
палеоантропологов: палеоантропологов
данные: данными данные
оказаться: оказалось
интерес: интерес
запечатлеться: запечатлелись
синхротронной: синхротронной
структура: структуре
годовой: годовым
территория: территории
версия: версий версией
какой: каком
австралопитеков: австралопитеков
подросток: подростка подростку
относиться: относятся
физический: физической
неандертальца: неандертальца
приезжать: приезжают
голубой: голубые
одновременный: одновременно
удалось: удалось
эволюция: эволюция эволюции эволюцию
первопричина: первопричиной
конформности: конформности
африка: африки
незадолго: незадолго
отражать: отражает
складываться: складывается
начаться: началась
срез: срезы
ясный: ясно
положение: положение
большой: большой
бесценный: бесценных
моляры: моляры
объемы: объемы
социальный: социального социальной социальному
примерно: примерно
замедленный: замедленное замедленного замедленным
динамика: динамику динамике
стареть: стареют
жить: живут
опубликованы: опубликованы
объект: объектом объектов
понятный: понятно
коэволюция: коэволюция
мощный: мощным
сохраняться: сохраняется
осью: осью
непомерный: непомерное
прекращать: прекращают
примат: приматам
основный: основной
интерпретация: интерпретациями
ускорение: ускорению ускорения
зависимый: зависимыми
обезьяний: обезьянья обезьяньей
общий: общего общий общей
огромный: огромный
проводиться: проводилось
центр: центре
синхротронного: синхротронного
максимум: максимума
пятилетний: пятилетнем
изображение: изображения изображение изображениях
помощь: помощи помощью
благодаря: благодаря
начать: начало
сапиенсы: сапиенсы
уточнить: уточнить
показатель: показатель показателей
увеличение: увеличение увеличения
недоразвитый: недоразвитым
такой: таких таким
намного: намного
увеличиваться: увеличивается
дентин: дентина дентин дентине
меньшой: меньшим
оставаться: остаются оставались
отбор: отбором отбору
родившийся: родившихся
новорожденного: новорожденного
изношенный: изношенных
оценивать: оценивать
жившего: жившего
беспомощнее: беспомощнее
коррелирует: коррелирует
детство: детство детства детстве
постнатальный: постнатальный
сутки: суток
неандертальцы: неандертальцы
ученые: ученые
особь: особей особям
рождаться: рождаться
скудный: скуден
участок: участков
согласный: согласно
ход: ходе
отрывочный: отрывочные
крайний: крайне
репродуктивный: репродуктивного
взросления: взросления
скоррелировать: скоррелировать
снижаться: снижается
отличие: отличием отличий
наряд: наряду
скорый: скорее
мудрость: мудрости
соответствовать: соответствуют
позволить: позволило позволил
наших: наших
сравнение: сравнению
находка: находки находок
причем: причем
последовательность: последовательность последовательности
требовать: требуют
внутригрупповой: внутригрупповой
имеющийся: имеющихся имеющиеся
достаточный: достаточно
андресена: андресена
скорость: скорость скоростью скорости
удлинение: удлинение
отрезка: отрезка
рост: рост роста
высочайший: высочайшем
кольцо: кольцам
вполне: вполне
рентгеновский: рентгеновской
скелет: скелет скелеты
неуклонный: неуклонно
увидеть: увидеть
красный: красные красная
передний: передним передние передних
целый: целом
стимулировать: стимулировать
волна: волн
реконструировать: реконструировать
превосходить: превосходить превосходили
степень: степени степень
предполагаемый: предполагаемое
элемент: элементы
уровень: уровнями
современный: современной современных современными современным современного
постоянный: постоянных постоянные постоянный
мозг: мозг мозга мозгом
быстрый: быстрый быстрого быстрее
одним: одним
достигать: достигают достигает достигала
замедлилось: замедлилось
проливать: проливает
происходить: происходит
развитие: развитие развития развитием
реальность: реальности
прилагающейся: прилагающейся
меняться: менялся меняется
график: график
сторона: стороны
орангутанов: орангутанов
молярами: молярами
грудной: грудное
близкий: ближе
палеоантропологи: палеоантропологи
очередь: очередь
зуб: зубы зубам зубов зуба зубах
считаться: считается
жившей: жившей
тысяча: тысячи
парантропам: парантропам
единственный: единственном
информация: информации информацию
родительский: родительской
мать: мать
коэволюции: коэволюции
масштабный: масштабного
память: память
допущение: допущении
суточный: суточные суточному
реконструированные: реконструированные
другой: другими другом
культура: культуры
изменение: изменения
стресс: стресс
человек: людей людьми человека людям человеком
обладатель: обладатель
летопись: летопись
рожать: рожать
способность: способности
процесс: процессе
журнал: журнале
косвенно: косвенно
европейский: европейском
разноцветный: разноцветные
марков: марков
высокий: высоким высокого выше
афарских: афарских
изучение: изучение
выделять: выделяют
орангутанам: орангутанам
получены: получены
важный: важным
перенесен: перенесен
последствие: последствий
нарушение: нарушений
дендрохронологии: дендрохронологии
фазово: фазово
подсчитать: подсчитать
премолярами: премолярами
реакция: реакцией
младенческий: младенческой
препятствие: препятствия
ритм: ритм
нормальный: нормальную
микротомография: микротомография
род: рода
понять: понять
каждый: каждого
эпизод: эпизодов
расчет: расчет
существенно: существенно
зрелость: зрелости
материал: материал
формироваться: формироваться
разный: разной
вид: вид виде видов
отношение: отношению отношения отношении отношениях
надежную: надежную
источник: источник
позволять: позволяли позволяют
годы: годы
большеголовый: большеголовых
стадия: стадию
трех: трех
признак: признакам
место: место
отличаться: отличались отличается
ретциуса: ретциуса
данный: данного данном
идти: шло
долгий: долгое долгий долгого дольше долгом долгим
появиться: появилась
трудный: трудно
предположительно: предположительно
палеоантропологический: палеоантропологический
жизнь: жизни
размножаться: размножаться
благоприятный: благоприятные
сохранившихся: сохранившихся
гренобле: гренобле
суммарный: суммарный
изменчивый: изменчивой изменчивы
итоговый: итоговому
грузинский: грузинских
ускоренный: ускоренной
землекоп: землекопов
объема: объема
этап: этапе этапов
зеленая: зеленая
показаны: показаны
продолжать: продолжает продолжали
семейный: семейные
показано: показано
рисунок: рисунок
верхний: верхней верхний
линия: линии линиям линий линия
своеобразный: своеобразная
отражающих: отражающих
поверхность: поверхности
детальный: детальную
деталь: деталях
линяя: линяя
снижение: снижение
происхождение: происхождения
слойка: слойки
помимо: помимо
ранний: ранних раннем ранним раннего ранние
гораздо: гораздо
начинать: начинают начинает
второй: вторых
цикл: циклу циклы цикла
годам: годам
разрастание: разрастание
особенность: особенность
разум: разума
периодичность: периодичности периодичностью
восьми: восьми
клык: клыкам клыки
старший: старших
тонкий: тонкими тонкие
развиваться: развивались развиваются
период: период периоды периоде
многие: многих
сравнить: сравнить
подробный: подробные
ускоряться: ускорялось
синий: синие синяя
ардипитеки: ардипитеки
итог: итоге
иметь: имеют
цвет: цветом
имевшиеся: имевшиеся
неплохой: неплохо
зависимость: зависимости
эндокранов: эндокранов
идея: идеей
обсуждаемой: обсуждаемой
объему: объему
отметина: отметинам
речь: речь
челюсть: челюсти
зеленым: зеленым
задний: задних задними задние
повлечь: повлекло
морфология: морфология морфологии
гипопластических: гипопластических
размер: размером
знать: знать
моляр: моляр
череп: череп черепа черепов
премоляров: премоляров
способствовать: способствовать способствовали
поведение: поведения
нейрохимическая: нейрохимическая
швейцарский: швейцарских
стрессовых: стрессовых
возможный: возможно
метода: методы метод методам
пропитание: пропитания
беспомощность: беспомощности
томографии: томографии
остается: остается
гипоплазий: гипоплазий
факт: факт
понимание: пониманию
возраст: возраст возрастом возраста возрасте
шимпанзиному: шимпанзиному
промежуточный: промежуточной промежуточное
поэтому: поэтому
толщина: толщиной толщины
делаться: делается
вывод: вывод
умелый: умелым
резец: резцам резцы
размах: размах
грузия: грузии
заполнять: заполняют
представитель: представителя представителей представителе
популяция: популяции
разглядеть: разглядеть
закладывающийся: закладывающийся
экология: экологии
увлекаться: увлекаться
идет: идет
вопрос: вопрос
французский: французских
рис: рис
разрешение: разрешением разрешения разрешении
черта: черта черт
детеныши: детеныши
индивид: индивида индивид
изученные: изученные
редкий: редки
значительный: значительной
условие: условия
темп: темпах темпам темп
знаменитый: знаменитом
заботиться: заботились
компьютерный: компьютерной
добыча: добыче добычи
нагрузка: нагрузку
непростой: непростая
трехмерные: трехмерные
стрелочка: стрелочки
эндокрана: эндокрана
средний: среднем
вскармливание: вскармливание
взрослый: взрослому взрослых
вскоре: вскоре
состоять: состоит
являться: является
медленный: медленное медленнее медленного медленно
ювенильным: ювенильным
ноябрь: ноября
австралопитекам: австралопитекам
результат: результаты
показать: показал
детенышей: детенышей
потомство: потомстве
план: плане
жизненный: жизненного
человеческий: человеческим человеческого человеческие человеческая человеческому человеческой
задача: задача
постепенный: постепенно
постнатального: постнатального
исследование: исследование исследования
точный: точные
наглядный: наглядно
ребёнок: дети детях
выяснить: выяснить
установить: установить
вымерший: вымерших
расти: расти растут
заметный: заметные
эмаль: эмали эмаль
оранжевый: оранжевые
молочный: молочных
удлиняться: удлиняться
откладываться: откладываются откладывались
максимальный: максимальной
сценарий: сценарию
микроструктура: микроструктуру микроструктуры микроструктуре
шимпанзе: шимпанзе
ключ: ключ
рождение: рождения
стать: стали стало
выделенный: выделены
следовать: следует
прямоходящий: прямоходящим
цепочка: цепочку
свет: свет
ежегодно: ежегодно
сверхподробных: сверхподробных
строиться: строился
список: списке
индивидуальный: индивидуального индивидуальной индивидуальных
задолго: задолго
изменчивость: изменчивости
момент: момент
слой: слоями
формировались: формировались
догонять: догонял
дманиси: дманиси
предок: предков
становление: становления
корень: корни
самый: самые
прерывающих: прерывающих
статья: статьи
зачаток: зачатков зачатки
дело: деле
стоять: стоит
первый: первые первых первым
вероятный: вероятный
относительный: относительно
жевательный: жевательной
обучение: обучению
антропогенеза: антропогенеза
излучение: излучения
сумма: суммы
проанализировать: проанализировали
случай: случае
окклюзионной: окклюзионной
новорожденные: новорожденные
забота: заботы заботе
произойти: произошли
конкуренция: конкуренции
двух: двумя
воксела: воксела
теоретически: теоретически
простой: проще
понимаемое: понимаемое
млн: млн
подкреплять: подкрепляет
вынужденный: вынужденной
длина: длина
человекообразный: человекообразных
задержка: задержка задержкой
частность: частности
создавать: создавало
шести: шести
одном: одном
механизм: механизм
голый: голых
третий: третьих
объясняться: объясняется
причина: причинами
переживать: переживает
основанный: основанная
преодолевать: преодолевают
австралопитеки: австралопитеки
кооперативный: кооперативной
сильный: сильный сильно
образец: образце
новый: новый новым новые
симметричным: симметричным
комплекс: комплексу
принадлежать: принадлежал
получить: получить
включая: включая
нижний: нижней нижний
траектория: траектории
замедление: замедление
культурный: культурной культурного
отнести: отнести
виртуальный: виртуальные
мкм: мкм
гипотеза: гипотезой гипотеза гипотезу
спорный: спорным
предпосылка: предпосылок
древнейший: древнейших древнейшей
гоминид: гоминид
премоляры: премоляры
извлечь: извлечь
обучаемости: обучаемости
время: времена
метод: методов
распространение: распространении
синхротронная: синхротронная
юный: юных
использование: использования
целовать: целую
снижать: снижало
необходимый: необходимо
тот: той
моляров: моляров
согласоваться: согласуются
предел: пределами
горизонтальный: горизонтальной
намекать: намекает
типичный: типичные
нарастание: нарастания
занимать: занимает
отличительный: отличительная
найденных: найденных
брешь: брешь
александр: александр
микротомографии: микротомографии
горилла: горилл гориллам гориллы
говориться: говорилось
эволюционный: эволюционной
изучить: изучить
контрастный: контрастная
отсутствующий: отсутствующие
замедляться: замедляться
смерть: смерти
микрон: микрон
показывать: показывает показывают
тип: типов типа
