корм: корма корм
подобный: подобные
увеличиваться: увеличивался
клетка: клетка клеткой
тормозной: тормозных
исследованный: исследованных
известный: известно
делать: делать
слепок: слепки слепкам
начинка: начинка
путь: путями путь
современный: современных современные
филогенетическое: филогенетическое
повторить: повторил
квадратик: квадратиками квадратик
обозначены: обозначены
занимающихся: занимающихся
таковой: таковыми
избежать: избежать
схема: схема схеме
зеленого: зеленого
решать: решать
открутить: открутил
эволюция: эволюцию эволюция эволюции
любить: любят
базальной: базальной
плащ: плащ
изобрести: изобрели
совместный: совместном
гейдельбергского: гейдельбергского
филогенетических: филогенетических
выемка: выемками выемкам выемкой выемки выемок
стандартный: стандартным
продвинутый: продвинутые
собираться: собираются
диатримовых: диатримовых
содержаться: содержались
поворот: поворот
вроде: вроде
представлять: представляет представляют представляла
группа: группу группами группой
различный: различных
большинство: большинство
настолько: настолько
маркирующим: маркирующим
салат: салата салат
сложный: сложной сложного
встречаться: встречается
обладающие: обладающие
полезный: полезным полезными полезных
ковчег: ковчег
предполагать: предполагают
столь: столь
цыплёнок: цыплят
появление: появлению
ответственный: ответственный
товарищ: товарищ
направление: направлении
станок: станок
баскский: баскского
откуда: откуда
любопытный: любопытного любопытная
небезосновательно: небезосновательно
разгуливающие: разгуливающие
первый: первых
принятый: принято
задаться: задаться
некоторые: некоторых некоторые
отправиться: отправились
положенный: положенного
круг: круге круг
морфологов: морфологов
реконструировать: реконструировать
стартовать: стартовало
обойтись: обойтись
какой: какими каких
животное: животных
форма: форму
настройка: настройку
продукт: продукты
прежде: прежде
ждать: ждать
двух: двумя
такой: такими
госпрограмм: госпрограмм
поэтому: поэтому
подразумевая: подразумевая
птица: птиц птицами птицы птицам птице птица
целить: цели
сходство: сходстве сходство
породив: породив
передний: переднего
руководство: руководстве
бристольского: бристольского
включающими: включающими
обсуждаемой: обсуждаемой
провести: провели
нейрон: нейроны нейронов
исследователь: исследователи
древние: древние
ветвь: ветвь
подробность: подробность
источник: источники
исключен: исключен
дать: дали дай
представитель: представители представителей
колесо: колесо колесе колесу колесом колеса
обусловленный: обусловлен
присутствующий: присутствующие
вне: вне
самый: самые самый
указан: указан
очертание: очертаниях
работающие: работающие
мышь: мышами
птичий: птичьего птичьих птичьем
гусеобразных: гусеобразных
добыть: добыли
расчетных: расчетных
бристоля: бристоля
ворона: ворон
больший: большие
должный: должны
уровень: уровень уровня уровне
утратить: утратили
реконструкция: реконструкции реконструкция реконструкцией
объему: объему
индивидуальный: индивидуального
предполагаться: предполагается
продвинуться: продвинулись
кора: коры
носорог: носорогами
полета: полета
возможный: возможных
космос: космос
профиль: профили
опубликованных: опубликованных
свободный: свободно
крепиться: крепился
принцип: принципе
собрать: собрала
сайт: сайта
вообще: вообще
данные: данные
постарайтесь: постарались
нанду: нанду
сопроводительный: сопроводительных
миро: мире
тип: типов
рассмотреть: рассмотреть
британский: британские
равный: равно
удачный: удачный
полету: полету
базовый: базовый
исходный: исходной
лопата: лопату
модель: моделью модель
следующий: следующий
подгонка: подгонка
филогенетическом: филогенетическом
относительный: относительному относительный относительно
прозрачный: прозрачным прозрачный
вороной: вороны
представительство: представительство
пропагандировать: пропагандируют
крупный: крупный крупным крупного
дроморнитид: дроморнитид
оказаться: оказались
работать: работать
круглый: круглые
печатный: печатный
требоваться: требуется
организованный: организован
журнал: журнала
кирпичик: кирпичиков
следовать: следует
интересовать: интересовало
решить: решили решил решила
задачка: задачки задачками задачку
вымерший: вымерших
проделать: проделал
обладать: обладают
мочь: могла могли
естественный: естественно
решение: решении решение решения
обсуждение: обсуждения
полушарие: полушария
исследование: исследования исследований исследование
бескилевых: бескилевых
маленький: маленького маленький наименьший
зоопарк: зоопарк зоопарка
вольер: вольере
предлагать: предлагать
ноев: ноев
вместе: вместе
проверить: проверить
соответствующий: соответствующие
выясняться: выясняется
предыдущий: предыдущем
ученые: ученые
славиться: славятся
большой: наибольший большой
совершенствование: совершенствованием
постепенный: постепенно
изобретательнее: изобретательнее
владелец: владельцы
фото: фото
специалист: специалисты специалистов
быстрый: быстрее
казуарами: казуарами
цвет: цветами цветом
желтый: желтый
умный: умными
основный: основные
адекватный: адекватной
число: число
изобретательный: изобретательному
появляться: появляется
посильнее: посильнее
генетический: генетические
достижение: достижений
видный: виден
винт: винт винта
публикация: публикации
трех: трех
покрашена: покрашена
двуногий: двуногим
побольше: побольше
возбуждающий: возбуждающие возбуждающих
креационизм: креационизм
задача: задачей задачу задачи
выполнять: выполняет
обделенные: обделенные
автор: авторы
забавный: забавно
университет: университета
новонебных: новонебных
смочь: смогут смогли
задание: задание
отдел: отделов
сравниваться: сравнивается
ответвившуюся: ответвившуюся
объесть: объем
понимание: понимания
параметр: параметр параметрам
экспериментатор: экспериментаторы экспериментаторам
гарсия: гарсия
проба: проб
кой: кое
который: котором которым
интеллект: интеллекта интеллект интеллекте интеллектом
способный: способны
обладатель: обладатели
родич: родичей
раз: разу
этологов: этологов
лучший: лучшие
начать: начало
размышляя: размышляя
примат: приматов
адаптация: адаптации
частный: частный
эволюционный: эволюционной эволюционный эволюционного эволюционно
слово: слова словами
наймарк: наймарк
сообразительный: сообразительных
дальний: далее
второй: вторых
схожий: схожие
красный: красного
повторять: повторяли
обслуживание: обслуживания
отверстие: отверстия отверстие
весьма: весьма
ученых: ученых
интеллектуальный: интеллектуальных
высокий: высоких
вторичный: вторично
уникальный: уникальным
включение: включение
понять: понять
ненадежный: ненадежный
хитрый: хитрой хитрых
ближайший: ближайшее
становление: становлением
точнее: точнее
паллиуме: паллиуме
начаться: началась
рефлекс: рефлексов
паллиум: паллиум
разбираться: разбираются
эволюционировать: эволюционировали
паллиума: паллиума
елена: елена
древний: древняя
дерево: дереве дерево
испытывать: испытывали
выполнено: выполнено
эму: эму
кормушка: кормушки
тест: тестов тестом
найти: нашли
видимый: видимому
консервативный: консервативными
интересный: интересно интересная интересных
голубой: голубого голубым
территория: территории
мотив: мотивы
отрицать: отрицали
парадигма: парадигмы
германий: германии
вид: видах виды видами
добраться: добраться
функция: функции функциями функций
способность: способность
показатель: показатели
целый: целом
сразу: сразу
одна: одна
пластик: пластик
ехать: еду
отряд: отрядом
зебра: зебрами
множество: множества
полагать: полагают
динозавр: динозаврами динозавров динозаврам
тинаму: тинаму
нуль: нуля
вытащить: вытащить
аналогия: аналогии
отчетливее: отчетливее
повтор: повтор
вероятный: вероятно
желающих: желающих
напрашиваться: напрашиваются
фантазировать: фантазировать
неожиданный: неожиданное
покрывающий: покрывающий
череп: черепов
полететь: полетели
позвоночный: позвоночных
достать: достать достал
показаны: показаны
курообразных: курообразных
палеогнаты: палеогнаты
судить: судить
идти: идти шло
страус: страусов страусам страусы страусах страуса
требовать: требует
результат: результаты результате
рис: рис
каскад: каскады каскадах
явный: явно
обеспечивать: обеспечивают
стартовый: стартовый
предложить: предложили предложил
породить: породил
тормозящие: тормозящие
поведенческий: поведенческой поведенческие
считаться: считается
чрезвычайный: чрезвычайно
прорыв: прорывах
редуцированный: редуцирован
иметься: имелись
подспорье: подспорьем
номер: номере
пристальный: пристально
небольшой: небольшой небольшим небольшое
другой: другими
маршрут: маршрут
академик: академиков
иначе: иначе
поведение: поведения поведению
точка: точки
периодически: периодически
закрутить: закрутить
морено: морено
сходный: сходные
сравнивать: сравнивают
общий: общего
достойный: достойны
иной: иными
лехоне: лехоне
вспомнить: вспомним
поверхность: поверхности
впечатляющий: впечатляющими
ориентироваться: ориентироваться
серьезных: серьезных
отдельный: отдельные
внутренний: внутренней
работа: работ работах
млекопитающий: млекопитающих млекопитающие
киви: киви
черепаха: черепахами
нейронный: нейронном нейронные нейронное нейронных
иметь: имеют
изучать: изучать
независимый: независимо
диаметр: диаметру
прийтись: пришлось
меря: мере
страусовых: страусовых
сова: совы
добыча: добыче
крутить: крутит
линия: линия линии линиях линий
сквозь: сквозь
статья: статье статьи
кесманна: кесманна
материал: материалов
образ: образом
справедливый: справедливо
размер: размер размеру
технологический: технологических
привести: привела
прорисовываться: прорисовывается
среди: среди
конвергентной: конвергентной
инновационному: инновационному
приходиться: приходится
одни: одни
рисунок: рисунок
повернуть: повернуть
ход: ходе
развитие: развития развитие
испания: испания
совместилось: совместилось
вопрос: вопросом
попугай: попугаев попугаи
ящерица: ящериц
расчетов: расчетов
разный: разных разная
демонстрировать: демонстрируют
развиваться: развивался
млекоптитающих: млекоптитающих
эксперимент: эксперименты экспериментов эксперимент
удобный: удобными
активный: активная
координация: координация
обслуживать: обслуживали
фернандо: фернандо
ствол: ствола
нескольких: нескольких
хенрика: хенрика
скудны: скудны
мозговых: мозговых
разобрано: разобрано
киль: киль
центральный: центральный
черный: черный
сообразительность: сообразительность сообразительностью
древо: древа
процесс: процесс
арена: ареной
образовательный: образовательных
аспект: аспект
нужный: нужное
отвинчивание: отвинчивание
бескилевые: бескилевые
нелетающих: нелетающих
закрываться: закрывалось
становиться: становились
рост: рост
кстати: кстати
компьютер: компьютер
справиться: справились справиться справился
мозг: мозг мозга мозгом мозге мозгов
натыкаться: натыкались
