регулярный: регулярно
вполне: вполне
история: истории историю
юрском: юрском
появившийся: появившийся
обилие: обилию
сохранить: сохранить
прийти: пришли
остров: острова
прошлое: прошлое
центральный: центральной
тетиса: тетиса
найдены: найдены
уникальный: уникальная
пермо: пермо
крайний: крайне
немногий: немногим
успешный: успешно успешных
древние: древние
напоминающими: напоминающими
короткошеие: короткошеие
древо: древе
лес: лесом лесами
сохраниться: сохранился
ученые: ученые
первый: первые
остаток: остаткам остатки остатков
полушарие: полушария
журнал: журнале
форма: форме
предел: пределами пределы
земля: земли земле
ракообразный: ракообразными
одними: одними
элемент: элементы
например: например
панталасса: панталасса
достигать: достигать достигали
пангеи: пангеи
плавать: плавали плавал
способ: способ
увидеть: увидеть
родственник: родственники родственников
внушительный: внушительны
море: моря морях
линия: линиями линии
эволюционный: эволюционные эволюционной эволюционном
доминировавшие: доминировавшие
стремительный: стремительно
триасовом: триасовом
балмакаан: балмакаан
затапливавших: затапливавших
разрушенный: разрушенный
сомнительный: сомнительные
огромный: огромному
триасовых: триасовых
северо: северо
арктический: арктические
полностью: полностью
ранний: ранней ранние ранних
присутствовать: присутствовали
разнообразию: разнообразию
моллюск: моллюсками
освоить: освоить
экологический: экологические
приполярные: приполярные
представленный: представленные
зеландии: зеландии
причем: причем
предок: предков предкам
рептилия: рептилий рептилии
погреться: погреться
жизнь: жизнью жизни
переплывать: переплывали
соответствовать: соответствует
такой: такими таких таким
высокий: высоких
великий: великого
антарктида: антарктида
удлиняться: удлиняться
обсуждаемой: обсуждаемой
принадлежать: принадлежал принадлежать
окаменелость: окаменелость
отложение: отложений
поверхность: поверхности
океан: океан океаны океанах океана
рисунок: рисунок рисунке
уничтожившего: уничтожившего
животное: животными животного
пунктирный: пунктирными
описавшие: описавшие
мочь: могли
завроптеригий: завроптеригий
успех: успехи
полагаться: полагалось
положение: положение
опубликованной: опубликованной
отдохнуть: отдохнуть
выяснить: выяснили
вода: воды водах водам вод
палеоширотах: палеоширотах
вновь: вновь
единственный: единственный
древнейший: древнейших древнейшие
плезиозавр: плезиозавры плезиозавров
шея: шея
триасу: триасу
особенность: особенности
вид: видов виды
пахиплеврозавр: пахиплеврозавр
триасового: триасового
беспозвоночный: беспозвоночных
нотозавры: нотозавры
нотозавров: нотозавров
круиз: круизы
достигнуть: достигли
южный: южной южного
больший: большую
подходить: подходили
крупнейший: крупнейших
точка: точку
вылезать: вылезать
ветвь: ветви
нашить: нашей
нотозавра: нотозавра
семиметровой: семиметровой
показаны: показаны
утолщение: утолщений
вырост: выростов
динозавр: динозавры
протяжение: протяжении
современный: современного
надотряд: надотряд
выйдя: выйдя
благодаря: благодаря
берег: берег берега берегов
водный: водных
пресмыкающееся: пресмыкающихся
частичный: частично
сайт: сайта
последующий: последующем
отдельный: отдельных
путешествовать: путешествовали
крупный: крупные
звездочкой: звездочкой
судить: судить
длинный: длинная
хищный: хищных
бронированный: бронированных
рисковать: рисковали
шпицбергена: шпицбергена
полярный: полярные
какой: каким
береговой: береговой
освоение: освоение
поставить: поставить
охота: охоты
добраться: добрались
исследователь: исследователи
регион: регионы
образ: образом
отправляться: отправляться
завроптеригии: завроптеригии
трех: трех
существование: существование
обнаружение: обнаружения
подтверждать: подтверждает
спор: споре
связь: связи
мезозоя: мезозоя
конечный: конечном
место: место
осваивать: осваивали осваивать
группа: групп группами группы
покрытый: покрыты
изобиловать: изобиловали
согласный: согласно
найденный: найденный
предполагаемый: предполагаемые
тетис: тетис
эра: эры
плиозавры: плиозавры
начало: начале
жила: жил
вдоль: вдоль
ящер: ящеры ящеров
итог: итоге
путь: пути
вдобавок: вдобавок
вывод: выводам
изобилующих: изобилующих
разнообразный: разнообразной разнообразных
сушь: сушей
весь: всей
млн: млн
триасовое: триасовое
экосистема: экосистемах экосистемы
плыть: плыли
метр: метров
статья: статьи
распространение: распространения
извлечена: извлечена
освободившиеся: освободившиеся
растение: растений
восточный: восточной
долгий: долгие
суперокеана: суперокеана
поприще: поприще
помочь: помогла
среди: среди
обозначено: обозначено
продолжить: продолжить
рыба: рыбой
сравнительный: сравнительно
распространиться: распространились
новый: новой новый нового
освобождение: освобождения
ниша: ниши
беззубый: беззубый
ящерица: ящериц
сплошной: сплошными
завроптеригиям: завроптеригиям
костный: костных
находка: находка находки
свыше: свыше
день: дня
плакодонтов: плакодонтов
обладатель: обладателем
появиться: появились
ихтиозавр: ихтиозавры ихтиозавр
планета: планеты
возможный: возможные
нотозавр: нотозавр
заросший: заросшие
вскоре: вскоре
сформировались: сформировались
привести: привело
дальнейший: дальнейшем
прибрежный: прибрежным прибрежных
частить: части
часть: частей часть
занимавшего: занимавшего
конец: конца конце
опустевший: опустевший
картинка: картинки картинке
охотящихся: охотящихся
судя: судя
одни: одни
начать: начали
пылесос: пылесос
формация: формации
дракон: дракон
стройный: стройных
переплыв: переплыв
находиться: находится
показывать: показывает
всевозможный: всевозможные
приполярных: приполярных
встречаться: встречались
новозеландские: новозеландские
миграция: миграции
дополнительный: дополнительных
суперконтинента: суперконтинента
побережье: побережья
отсутствие: отсутствие
анна: анна
пермский: пермского
позволить: позволило
тип: типа
появившись: появившись
подводный: подводной
территория: территория
жаркий: жаркому
отодвигать: отодвигает
мезозойский: мезозойской
плакодонты: плакодонты
юг: юге юга
возраст: возрасту возраст
средний: среднему
ближайший: ближайшие ближайших
пангея: пангея
строение: строения
панталассы: панталассы
период: периода периоде
позвонок: позвонка позвонок
мировой: мировой мирового
оконечность: оконечности
позиция: позиции
представитель: представители представителям
составлять: составляет
сожаление: сожалению
палеозозойской: палеозозойской
четверть: четвертей
захватить: захватить
доминирующий: доминирующие доминирующее
древний: древний древнего
течение: течениями
новиковская: новиковская
необычный: необычные
опустевшие: опустевшие
самый: самые
морской: морских морские морской морскими
предположение: предположениям
единый: единого
панталассу: панталассу
климат: климату
теплые: теплые
датировка: датировка
утратить: утратили
миллион: миллионы миллиона
северный: северного северной
идти: шло
вырастать: вырастали
длина: длины длину
некоторые: некоторые некоторым
источник: источник
сухой: суше
массовый: массового
вымирание: вымирания вымирание
питаться: питались
север: севера
шельфовых: шельфовых
удалось: удалось
небольшой: небольшими
западный: западного западных
указывать: указывают
