размножение: размножения
зигоспоры: зигоспоры
охлаждение: охлаждения
несмотря: несмотря
ответить: ответить
норма: норме
растение: растений
день: дня дней дни дням днях дню
начинать: начинает
ненасыщенных: ненасыщенных
счет: счет
ситуация: ситуация
днк: днк
выживаемости: выживаемости
готовиться: готовились
белковый: белковые
играть: играет
обсуждаемой: обсуждаемой
некоторые: некоторых
растущих: растущих
фотопериоды: фотопериоды
разворачивать: разворачивают
поскольку: поскольку
показывать: показывает
повышение: повышение
использовать: используют использовали
ученые: ученые
достигать: достигает
данный: данного
фоторецепторами: фоторецепторами
уровень: уровня уровне
похожий: похожий
запасание: запасание
эффективность: эффективность
эксперимент: эксперимента эксперименты эксперимент
размножаться: размножаться
показывающие: показывающие
интересовать: интересовали
новый: новых
контроль: контроль
плато: плато
основный: основной основных
адаптироваться: адаптировались адаптируются адаптироваться
подходящий: подходящих
обнаружить: обнаружили обнаружить
геронтология: геронтологии
оказаться: оказались оказалось
продолжительность: продолжительностью
график: графики график
факторов: факторов
стимуляция: стимуляцию
семя: семян
желание: желание
качество: качестве
поставиться: поставили
фотосинтеза: фотосинтеза
цианобактерии: цианобактерии
температура: температуры температура температурам
помимо: помимо
увеличиваться: увеличивается
различный: различные
наверняка: наверняка
обозначены: обозначены
зависимость: зависимости
погружать: погружали
отдельный: отдельной
тепловая: тепловая
заморозки: заморозками
выделить: выделить
аскомицета: аскомицета
простой: проста
стрессовые: стрессовые
динофитовой: динофитовой
прорастать: прорастали
светлый: светлое светлого
спустя: спустя
задача: задачу
механизм: механизм
изменять: изменяли
определенных: определенных
активация: активация
зависеть: зависит
полутора: полутора
причем: причем
фотопериодов: фотопериодов
нормальный: нормальную
понемногу: понемногу
фотопериодизм: фотопериодизм
животное: животных
рост: роста
роль: роль роли
объект: объекта
темного: темного
подниматься: поднимается
частичный: частично
светового: светового
свет: свет света свету
ориентируясь: ориентируясь
вовлеченных: вовлеченных
исследователь: исследователи
способность: способность
модельный: модельного
активный: активно
выживать: выживать
будущий: будущими будущем
карбоксисомы: карбоксисомы
освещенности: освещенности
известный: известно
световом: световом
петри: петри
помещать: помещали
выживший: выживших
граница: границей
электронный: электронная
чувствительный: чувствительны
попадание: попадание
узнать: узнать
образ: образом
справа: справа
нокаутированными: нокаутированными
поколение: поколения поколение
ночь: ночи
лед: лед
решить: решили
повышается: повышается
шаперонов: шаперонов
реакция: реакции реакция реакций
нокаут: нокаутом
самый: самых
наличие: наличие
утро: утро
течение: течение
экспрессируются: экспрессируются
включаться: включаются
сезонный: сезонные
журнал: журнале
состав: состав
спор: споры
дно: дне
происходить: происходит происходила происходят
стресс: стрессом стресс
ультрафиолета: ультрафиолета
цветение: цветение цветению цветением
встречаться: встречается
конформацию: конформацию
слева: слева
контрольный: контрольного
дополнительный: дополнительные
изображение: изображение
ответ: ответ ответа
вдвое: вдвое
минимальный: минимальная
фотопериодических: фотопериодических
запускать: запускает
фитохромы: фитохромы
световые: световые
метаболизмом: метаболизмом
полимераза: полимераза
световому: световому
влад: влад
условие: условиях
независимый: независимо
делить: делили
повышенный: повышенной
источник: источник
фиксировать: фиксировали
вечер: вечер
культивировались: культивировались
циркадные: циркадные
увеличивать: увеличивает
увеличить: увеличить
многоклеточный: многоклеточные
синий: синему
тело: тела
длинный: длиннее длинных длинные
мочь: могло
адаптация: адаптация адаптации
промежуточный: промежуточную
карта: карта
адаптивные: адаптивные
часы: часов
интенсивность: интенсивности
позволять: позволяет
связанный: связанные
показывающая: показывающая
частить: части
похолодание: похолодания похолоданию
темное: темное
появиться: появилась
ранний: ранних
шести: шести
содержавшиеся: содержавшиеся
цель: целью
пик: пика
мелатонин: мелатонин
часовом: часовом
фосфат: фосфат
короткий: коротких короче короткого короткий короткие
разрыхляют: разрыхляют
живущий: живущих
вопрос: вопрос
повторно: повторно
ключевой: ключевую ключевые
мутант: мутантов
активировать: активировали активирует
регулировать: регулирует регулируют
стимулировать: стимулирует
изучить: изучить
шаперона: шаперона
явление: явление
раз: раза
замерзание: замерзания
глобальный: глобальному
световой: световой
разбить: разбили
такой: таких таким
клеточный: клеточных
однозначный: однозначно
уметь: умеют
жизненный: жизненным жизненного жизненный
красный: красный
отличать: отличать
эпигенетики: эпигенетики
случай: случаях
показать: показали
ответственный: ответственным
зимующих: зимующих
кислота: кислотами кислот
длина: длину длине длины
выживаемость: выживаемость
криптохромы: криптохромы
протяжение: протяжении
влияя: влияя
резкий: резко
гликоген: гликоген
менять: меняет
одноклеточный: одноклеточных одноклеточной одноклеточная
характерный: характерна
ген: генам гены генами генов гена
темнота: темноте
культивирование: культивирования
кодируются: кодируются
помочь: помочь
гриб: грибов гриба
регулируется: регулируется
контролировать: контролируют
млекопитающий: млекопитающих
мелатонина: мелатонина
описанный: описан
резуховидки: резуховидки
расти: росли росла
реагировать: реагируют
свидетельствовать: свидетельствовать
развиваться: развивалась
быстрый: быстро быстрее
рнк: рнк
рис: рис
предвидеть: предвидеть
падать: падает
очередь: очередь
эволюция: эволюции
группа: группы
среди: среди
какой: какие какими
статья: статьи статья
транскрипционного: транскрипционного
снижение: снижение
фактора: фактора
свернуться: свернулись
борьба: борьбе
экспрессируется: экспрессируется
цианобактерий: цианобактерий
участвовать: участвуют
циркадных: циркадных
измерять: измерять
час: часа
переживать: переживали
запасать: запасать
потепление: потеплению
тилакоидные: тилакоидные
автор: авторы
водоросль: водорослей водоросли водоросль
промышленность: промышленности
чашка: чашки
доза: дозой
сворачиваться: сворачиваться
холодный: холодных
различать: различать
цикл: циклы циклом цикла циклов цикл
гликогена: гликогена
поздний: поздние
белка: белки белка белкам
умеренный: умеренный умеренных умеренном
предсказывать: предсказывать
вегетативный: вегетативного
дальний: дальний
регуляция: регуляции
примерно: примерно
ассоциирован: ассоциирован
ученых: ученых
аденилилтрансферазы: аденилилтрансферазы
буква: буквами
липидных: липидных
лето: летом
описать: описали
секвенирования: секвенирования
экспрессия: экспрессию экспрессия
сквозь: сквозь
помещение: помещения
таля: таля
мембрана: мембраны мембран мембрану
агрегат: агрегаты
ассоциированы: ассоциированы
ростовых: ростовых
возможный: возможно
любой: любое любой
пониженный: пониженной пониженным
начатой: начатой
заранее: заранее
детектирования: детектирования
транскриптов: транскриптов
синтез: синтез
путь: пути
пластичность: пластичность
температурный: температурных
летний: летних летнее летний летнем
каждый: каждой
образовывать: образовывает
находить: находили
измениться: изменилась
например: например
зима: зимой
высокий: выше высокой
ритм: ритм ритмов ритмы
переход: переход
жирный: жирными жирных
недавний: недавняя недавней
длительность: длительностью длительности
полимеразы: полимеразы
липидов: липидов
глюкозо: глюкозо
правильный: правильно
водоемов: водоемов
зимний: зимнюю зимних зимний зимнем
установить: установили
который: которую которыми
количество: количества количество
неправильный: неправильно
бактерия: бактерий бактерии бактериям бактерия
подавлять: подавляет
процесс: процессы
число: число числу
протокол: протокол
лёд: льду
грядущий: грядущие грядущим грядущему
помощь: помощи
разный: разных разной разного
организм: организмов организмы
выступать: выступает
рисунок: рисунок
пропорция: пропорции
сигма: сигма
солнечный: солнечным
предполагать: предполагают
специальный: специальные
фотопериодизме: фотопериодизме
светочувствительный: светочувствительные
лёгкий: легче
ежегодные: ежегодные
делившихся: делившихся
схема: схема
режим: режимах режиме режима
минута: минут
атфазы: атфазы
суточный: суточный
плодовый: плодовые
связываться: связываться
результат: результатам результате
спячка: спячку
росших: росших
вдобавок: вдобавок
помогать: помогают
прорастание: прорастание
выжить: выжило
удалось: удалось
этап: этапах
пять: пяти
изменить: изменили
наследоваться: наследуются
микрофотография: микрофотография
исследование: исследования исследование
удаваться: удавалось
изменение: изменения
секреция: секреция
