наличие: наличие
смещение: смещению
флуоресценция: флуоресценция
справа: справа
жгутиконосцев: жгутиконосцев
шаг: шаг
воспринимать: воспринимать
заставляющий: заставляющий
мозг: мозга
ведущая: ведущих
покой: покое покоя
эволюционный: эволюционно
зажечься: зажечься
источник: источник
воротничковый: воротничковый
депоряризующей: депоряризующей
отдельный: отдельный
грибной: грибных
маленький: маленького
создается: создается
форма: форме
подвижный: подвижный
антиаритмический: антиаритмический
перестать: перестанут
микроэлектродами: микроэлектродами
называть: называем
открытие: открытию
схема: схему
сопряжения: сопряжения
мостик: мостиками мостиков
красивый: красивых
иметь: имеет
розетка: розетки розеток розетках
удивление: удивление
заставив: заставив
микроскопический: микроскопических
демонстрировать: демонстрирует демонстрируют
непосредственный: непосредственно
натрий: натрия
желающие: желающие
материал: материалов
структура: структуры
единый: единое
купировались: купировались
сердечный: сердечной
уметь: умеет умеют
управлять: управлять
многоклеточность: многоклеточность
двигательный: двигательная
движение: движение движением
разница: разницей
особенность: особенность
гриб: грибов гриба
приложение: приложениях
действовать: действует
мембрана: мембраны мембране мембрана
сложный: сложные сложную
кишечнополостных: кишечнополостных
цитоплазматические: цитоплазматические
число: числе
интересный: интересны интересное
мочь: могли
нерв: нервам нервов
наших: наших
ток: токов ток током токи тока
многоклеточный: многоклеточные многоклеточного
электрофизиологии: электрофизиологии
слоистый: слоистые
самый: самых
деполяризуется: деполяризуется
выворачиваются: выворачиваются
внутри: внутри
значение: значение
бежать: бежит
сходство: сходство
снимать: снимает
блокаторами: блокаторами
факторов: факторов
университет: университета
повышение: повышение
развить: развить
сокращаться: сокращаются
электрический: электрическую электрических электрические электрической электрическая
разность: разность
образовать: образует
выворачиваться: выворачиваться
хоанофлагеллятах: хоанофлагеллятах
препарат: препаратом препарат
элемент: элементы
затруднительный: затруднительно
калий: калия
деполяризация: деполяризацию деполяризации деполяризация деполяризацией
отношение: отношению отношениях
дополнительный: дополнительных
главный: главный
организм: организма организм
решить: решили
анализ: анализ
результат: результат
видео: видео
сокращение: сокращению сокращения сокращение
активироваться: активировались
гораздо: гораздо
короткий: короткое
верапамилом: верапамилом
блокатором: блокатором
поток: поток потока
продемонстрировать: продемонстрировали
наружный: наружной
цитоплазматическими: цитоплазматическими
ген: геном ген
гадолинием: гадолинием
сигнализация: сигнализацию сигнализации сигнализация
помогать: помогают
заставить: заставить заставило
считаться: считаются
воротничковых: воротничковых
новый: нового
некоторые: некоторые
расходиться: расходиться
отвечать: отвечает
десяток: десятков
электропроводящей: электропроводящей
нервный: нервной нервных нервного
внедрить: внедрили
асинхронный: асинхронный
установленный: установленных
пример: пример
придает: придает
выгибаться: выгибаться
цитоплазматических: цитоплазматических
внутренний: внутренней внутренняя
прийти: прийти
потенциалзависимые: потенциалзависимые
агрегат: агрегаты
колгрен: колгрен
название: названия название
сложнее: сложнее
казаться: кажутся
изображение: изображение
создать: создать
рис: рис
дело: дело
вдоль: вдоль
регистрировать: регистрировать
статья: статьи статье
одна: одна
вашим: вашим
хоанофлагеллята: хоанофлагеллята
оказаться: оказалась
синхронизировались: синхронизировались
растение: растений
вспыхивать: вспыхивали вспыхивают
успеть: успела
жгутиконосец: жгутиконосец
жить: жить
сократиться: сократится
межклеточный: межклеточных межклеточную
колония: колонию колониях колонии колония
некоторый: некоторое
изредка: изредка
интенсивность: интенсивность
обычный: обычной
задуматься: задуматься
пропускать: пропускают пропускать
спонтанный: спонтанная
миозин: миозин
потенциал: потенциалов потенциалом потенциал потенциала потенциалы
уровень: уровне
проводить: проводить
милливольт: милливольт
пересекать: пересекает
отслежить: отслежить
развиваться: развивалась
запускается: запускается
вид: виде вида
иметься: имеются
напрямую: напрямую
вода: воды
куракин: куракин
светодиоды: светодиоды
осевших: осевших
клетка: клетки клетками клетках клеток
канал: каналы каналов
представитель: представителя
большой: большом
отмечать: отмечает
автор: авторов
хоанофлагеллят: хоанофлагеллят
сердце: сердца сердце
зачаток: зачатки
контакт: контактов контактам контакты
тип: типа тип
путь: путям
способ: способом
порядок: порядка
невозможный: невозможны
становиться: становится
посмотрев: посмотрев
высокий: высокой
упоминавшихся: упоминавшихся
указывать: указывает
подобный: подобные
встречаться: встречаются
записать: записать
насладиться: насладиться
деление: деления
ответ: ответ ответы ответа
координироваться: координируется
существовать: существует
регистрация: регистрация
запустить: запустить
исследование: исследование исследования
кратковременный: кратковременные
вспыхнуть: вспыхнуть
распространиться: распространиться
питаться: питаются
запускать: запускает
хоанофлагелляты: хоанофлагелляты
темнота: темноте
разнообразный: разнообразные
молекулярный: молекулярном
цепочка: цепочек цепочках
видный: видно видны
подавляться: подавляется
изучение: изучении
актин: актин
матрикс: матрикс
доказательство: доказательства
снаружи: снаружи
мелкий: мелкий
воротничок: воротничка
который: которую которыми
исследователь: исследователи
эффект: эффект
вверху: вверху
пробегающая: пробегающая
хлора: хлора
оставаться: остаются
наизнанку: наизнанку
красный: красного красным
животное: животных животного животными
мицелий: мицелий мицелия
микроскоп: микроскопом
асинхронные: асинхронные
позволить: позволила
кадр: кадр
присутствие: присутствии
терять: теряет
хоанофлагеллаты: хоанофлагеллаты
переставать: перестают
зрительный: зрительным
очищая: очищая
многоклеточности: многоклеточности
причем: причем
путем: путем
заряженный: заряжена
зрелище: зрелищем
добавление: добавление добавлением добавлении
вблизи: вблизи
гирлянда: гирлянде
зависимость: зависимости
помощь: помощью
порог: пороге
обеспечивающая: обеспечивающая
вступать: вступает
кальций: кальций кальция
образовывать: образовывать
выявить: выявил
скачать: скачать
георгий: георгий
аппарат: аппарат
расположенный: расположены
бергенского: бергенского
волна: волна
активный: активнее
отрицательный: отрицательно отрицательным
приспособить: приспособили
резкий: резко
электромеханического: электромеханического
норвегии: норвегии
добыча: добычу
очевидный: очевидно
обстоять: обстоит
такой: таком таким таких
человек: человека
слева: слева
ближайший: ближайшего ближайший ближайшие
читать: читаете
белка: белки белка
формировать: формировать
видеоархив: видеоархив
пороговый: пороговое
правда: правда
мышца: мышцах мышцы мышц
цитоплазму: цитоплазму
бактерия: бактерий
секретируют: секретируют
целый: целое
волокно: волокна волокну
интригующий: интригующий
внешний: внешней
находиться: находятся
соединённый: соединены
рассмотреть: рассмотреть
образ: образом
количество: количестве
флуоресцирует: флуоресцирует
простейший: простейшие
удивительный: удивительно
определенных: определенных
недавний: недавнее
представить: представить
подобие: подобие
мышечный: мышечная мышечные мышечных
вёшенки: вёшенки
минималках: минималках
являться: являются
видимый: видимо
клональной: клональной
жгутик: жгутики
простой: простейший простых проще
соседний: соседних
поэтому: поэтому
жгутиконосца: жгутиконосца
сам: самое
обсуждаемой: обсуждаемой
калиевый: калиевый
хоанофлагеллат: хоанофлагеллат
называться: называется
распространяться: распространяться распространяются
сайт: сайта
появление: появлении
условие: условиях
ехать: еду
действие: действия действие
флуоресцентным: флуоресцентным
показать: показало показал
похожий: похожей похожа
природа: природе
вести: ведут
приоткрыть: приоткрыл
подавление: подавление
предполагать: предполагают предполагает
щелевым: щелевым
текст: текст
ученые: ученые
красочный: красочным
одновременный: одновременно
большинство: большинства
паттерны: паттерны
приводить: приводит
внеклеточный: внеклеточный
перемычка: перемычки
процесс: процесс
биоток: биотоки
ион: ионов ионами
коммуникация: коммуникацию
ланцетники: ланцетники
внутрь: внутрь
биться: биться
аритмия: аритмии аритмию
одиночный: одиночных
герой: герой
сократительные: сократительные
флуоресцентного: флуоресцентного
иначе: иначе
корм: корма
натриевый: натриево
сократительный: сократительный
гадолиния: гадолиния
ткань: ткани ткань
выглядеть: выглядят
тайный: тайны
сторона: стороной сторона
принцип: принципе
кальциевый: кальциевых кальциевые кальциевым кальциевый кальциевого
сигнал: сигналов сигналы
вроде: вроде
например: например
проводящим: проводящим
робот: роботов робота
реагировать: реагировать
одноклеточный: одноклеточный одноклеточными одноклеточной
явный: явно
флуоресценцией: флуоресценцией
синхронный: синхронно синхронный синхронные
особь: особей
информация: информации
электрод: электродами
концентрация: концентраций концентрации
блокировать: блокировать
среда: среду
слизевики: слизевики
завеса: завесу
родственник: родственника родственник родственники
активность: активность активности
импульс: импульса
управление: управления
цветок: цветка
позвоночный: позвоночными
говорящий: говорящее
заставлять: заставляет
джеффри: джеффри
лавина: лавину
участок: участках
еда: едой
возможный: возможен
пассивный: пассивные
новогодний: новогодней
включать: включают
открываться: открываются
ионный: ионные
упрощенно: упрощенно
менять: меняет
образуя: образуя
зачаточный: зачаточной
возникать: возникают
способный: способный способны способные способного
