мочь: могли можем могла
сложнейший: сложнейшим
включить: включили
знак: знак
понимать: понимают
контакт: контакте
предок: предок предка предком
сетевидные: сетевидные
солнечники: солнечники
редуцирована: редуцирована
ветвь: ветви ветвях ветвь ветвей
относиться: относится относятся относился
признак: признаков признаки признак
перестать: перестала
эукариотические: эукариотические
участвовать: участвовали
стремиться: стремится
трипаносомы: трипаносомы
эволюция: эволюция эволюцией эволюции
восьми: восьми
некоторые: некоторые некоторыми некоторым некоторых
входящая: входящие
сосредоточиться: сосредоточились
наличный: наличной
выяснить: выяснить
биолог: биологи биологов
лишенные: лишенные
частица: частиц
дыхание: дыхание
морской: морские морских
работающих: работающих
край: крае
подтверждение: подтверждения
архея: архея
слово: слова
итак: итак
предлагать: предлагают
пора: поры
специализация: специализации
мезомицетозоев: мезомицетозоев
митохондрии: митохондрии
испания: испании
донный: донных
рука: рук
совершать: совершает
помнить: помнить
сергей: сергей
эволюционный: эволюционного эволюционные эволюционной эволюционное эволюционную эволюционный
оказаться: оказалась оказались оказаться
литература: литературу
изобрести: изобрели
буква: букв
оставив: оставив
сперматозоид: сперматозоидов
раковинная: раковинная
куст: кусту
мегастволу: мегастволу
теория: теория
параллельный: параллельной
проникать: проникали
плодовый: плодовое плодовыми плодовые
преобладать: преобладают
супергруппой: супергруппой
семи: семи
вновь: вновь
основный: основном основные основных
роджера: роджера
красивый: красивые
гиардия: гиардия
симбиотическое: симбиотическое
лаборатория: лаборатория
сообщить: сообщить
паразитический: паразитические
факт: фактов
добавить: добавила
внутренний: внутренние
цитоплазмы: цитоплазмы
сомнение: сомнений
данные: данные данных
пересборке: пересборке
спустя: спустя
рекомендоваться: рекомендуется
африканский: африканского
анкиромонад: анкиромонад
послужить: послужило
обсуждаемой: обсуждаемой
частность: частности
продвинутый: продвинутые
представлять: представляет
показанного: показанного
прочий: прочих
аластера: аластера
голосеменное: голосеменное
делать: делают
сравнение: сравнению
имеющий: имеющие
аналогичный: аналогичную
годиться: годится
якобидный: якобидный
двойной: двойного
форма: формой форму формы формами
присутствовать: присутствуют присутствовал
столь: столь
связано: связано
прокариотных: прокариотных
губка: губок
умалчивая: умалчивая
мегацарства: мегацарства
делиться: делится делятся
передаваться: передавался
активный: активно
стать: стали стало
центрохелидные: центрохелидные
неплохой: неплохо
рисунок: рисунок
микротрубочек: микротрубочек
исследование: исследование
вершина: вершины
дальнейший: дальнейшем
считать: считать считали
гемимастигофоры: гемимастигофоры
опистоконтов: опистоконтов
придаток: придатков
соединяться: соединяются
мелкий: мелкими
жить: жить
огромный: огромное
основание: основание основании основания
апузомонад: апузомонад
мегагруппа: мегагруппа
филогенетическом: филогенетическом
признать: признал
филогенетические: филогенетические
экскаватам: экскаватам
объясняться: объясняется
протистологии: протистологии
эукариотизации: эукариотизации
иметь: имеют
неясный: неясны неясно
палинтомическому: палинтомическому
анкиромонады: анкиромонады
пятый: пятого
обратить: обратим
линия: линией
озеро: озера
морейра: морейра
укреплять: укрепляет
аристотеля: аристотеля
участник: участники участников
преподавалась: преподавалась
предполагаемый: предполагаемых
исследователь: исследователи
процесс: процесса процессом процессы
жгутиконосец: жгутиконосец
установленный: установлено
дорсальная: дорсальная
собственный: собственные собственное
научный: научные
архей: архей
эукариогенез: эукариогенез
суметь: сумели
потенциал: потенциал
иллюстрация: иллюстрация
строение: строения
зародыш: зародышей
бактериальный: бактериальную
многие: многих многие
толкающий: толкающий
перемещаясь: перемещаясь
превосходить: превосходит
оставаться: оставалось оставаться
малочисленный: малочисленных
аластером: аластером
метамонады: метамонады
подробный: подробно
поэтому: поэтому
начнем: начнем
утратить: утратили
обсуждаться: обсуждается
жгутиконосных: жгутиконосных
пар: пара
кислородный: кислородное
супергруппе: супергруппе
поговорить: поговорить
второй: вторая вторых
оболочка: оболочка
относить: относят
являться: является являются
заняться: занялась
править: правило
затруднено: затруднено
благодаря: благодаря
плывущей: плывущей
четырех: четырех
становление: становление
перестраиваться: перестраивалось
колониальный: колониальная
осадки: осадках
архейную: архейную
таковой: таковой
аппарат: аппарат
жгутик: жгутики жгутик жгутиков жгутика
подписана: подписана
набор: набором набор
эукариотами: эукариотами
потеря: потеря
хищный: хищный хищные
криптофитовые: криптофитовые
классический: классические
возможный: возможно
родственный: родственных родственные родственны
разделены: разделены
некогда: некогда
усложнять: усложнять
хороший: хороший
симбионты: симбионты
трех: трех
рост: роста
чудовищный: чудовищно
хитридиевых: хитридиевых
соответствующий: соответствующие
область: области
никакой: никакого никаких
проблема: проблема проблемы
эндоплазматическую: эндоплазматическую
своем: своем
постепенный: постепенного постепенно
последний: последних последнего последняя последний последней
искать: искать
симбиотические: симбиотические
субстрат: субстрату субстратом
показано: показано
прямой: прямо
принадлежать: принадлежат
проходящая: проходящая
четко: четко
обстоять: обстоит
детальнее: детальнее
свойственный: свойственных
амебозоям: амебозоям
рис: рис
добавление: добавление
видимый: видим видимому
заметный: заметное
подвижный: подвижному
скорый: скорее
давид: давид
перевести: перевести
скорость: скоростью
рыхлый: рыхлого рыхлом
палеонтолог: палеонтолога
получить: получили получила
этимология: этимология
трактовка: трактовки
перевод: переводе
назвав: назвав
состояние: состояния состояние
серьезные: серьезные
обмениваться: обменивались
выделявшейся: выделявшейся
собрать: собрать
помещены: помещены
пурификасьон: пурификасьон
эукариот: эукариот
отношение: отношению отношения
говориться: говорилось
палинтомическое: палинтомическое
характерный: характерная характерные
супергруппах: супергруппах
бревиат: бревиат
прочить: прочь
пасущегося: пасущегося
ним: ним
канадский: канадских канадская
длинный: длинные
радиолярии: радиолярии
слизевики: слизевики
освоившие: освоившие
град: граду
степень: степени
сплошной: сплошной
исключить: исключить
амебозои: амебозои
поиск: поисках
происхождение: происхождение происхождения
бессмысленный: бессмыслен
выпустить: выпустила
специальный: специальными
сотня: сотен
мембрана: мембрана
сложный: сложно сложные
число: число числе числа
споровик: споровик
химера: химеры
запутанный: запутанными
эукариогенеза: эукариогенеза
сохраниться: сохранились сохранилось
передний: переднем
измерять: измеряй
переменный: переменной
приспособившись: приспособившись
кишечный: кишечные
гольджи: гольджи
привыкнуть: привыкли
существующий: существующие
загадка: загадкой
сонный: сонную
появляться: появляются
болезнь: болезнь
служащий: служащая
случай: случае случаях
увидеть: увидеть
путь: путях
полета: полета
первый: первая первых первого
филогенетику: филогенетику
бескислородном: бескислородном
высший: высшие
раковина: раковина
общепринятый: общепринятого общепринятым
бесцветный: бесцветные бесцветными
загадочный: загадочные
предложена: предложена
гриб: грибы грибов грибам
устроенный: устроенное
событие: событий события
животное: животные животных животными животным
цикл: цикла
нога: ноги
фагоцитоз: фагоцитоз
крупный: крупными крупные крупнее крупная крупных крупнейший
объясняющая: объясняющая
питание: питания
отчасти: отчасти
земля: земле земли
отказаться: отказались
буквальный: буквально
весь: всей
бритва: бритвой
источник: источника источник
ложноножек: ложноножек
ясный: ясно
слить: слили
палинтомии: палинтомии
нескольких: нескольких
крона: кроны
направление: направлении
интервал: интервалов
лишний: лишнего
протистология: протистология
остаток: остатки
сделать: сделать
экскаватным: экскаватным
коллаж: коллаж
проясниться: прояснилось
обновление: обновление
архаичности: архаичности
протей: протей
ризарии: ризарии
бурый: бурые бурая
мухомор: мухомор
заменить: заменить
таракан: тараканов
напоминать: напоминает
обладать: обладал
однозначный: однозначно
посмотреть: посмотрим
унаследовать: унаследовать
древо: древо древа древе
деление: делению делений деление
жгутиконосцев: жгутиконосцев
запутаться: запутаться
соответственный: соответственно
создание: созданию
тянущий: тянущий
имевших: имевших
мегаствол: мегаствол
эукариоты: эукариоты
цвет: цветом
поглощённый: поглощены
структура: структуры
уточнение: уточнениями уточнению
далеки: далеки
часть: часть частью
кристаллизоваться: кристаллизоваться
плавание: плавания
близкий: ближе близкие близки
отдельность: отдельности
латинский: латинские
велик: велика
существо: существа существом существу
связь: связей связи
упрощенное: упрощенное
помимо: помимо
секвенировали: секвенировали
великий: великого
ястреб: ястребов
черта: чертах черта черты
сложнее: сложнее
шести: шести
пожаловать: пожалуй
точный: точном
полностью: полностью
трудный: трудно
слабый: слабо
ризарий: ризарий
плавать: плавают
остаться: осталось осталась
возникновение: возникновения
момент: моменту момент
самый: самых самым самыми
отражены: отражены
описанный: описан
уточнено: уточнено
очередной: очередной
лёгкий: легко
статус: статусе
дискобы: дискобы
история: истории
накопиться: накопилось
зеленая: зеленая
наоборот: наоборот
передвигаться: передвигаются
симбиоз: симбиоза
вирус: вирусов
настоящий: настоящей настоящие
половина: половине
метеор: метеоры метеора
супергруппы: супергруппы
означающее: означающее
происходить: происходят происходили происходит
деталь: детали
гаптофитовым: гаптофитовым
обращенной: обращенной
период: периодов
приобрести: приобрести
элемент: элементы
вода: воду воды
помощь: помощью
важный: важных
век: века веков
популярный: популярную
малый: малые малых
причудливый: причудливых
пригодиться: пригодиться
похожий: похожий похож
якобид: якобид
потомок: потомки
франция: франции
сводиться: сводятся
гаптофитовые: гаптофитовые
жгутиковые: жгутиковые
вызывающий: вызывающие
член: члены членам членов
роль: роль
опуская: опуская
водный: водными водных
относительный: относительно
родство: родстве
вообще: вообще
клетка: клетки клетка клеткой клеток
закончиться: закончились
зеленые: зеленые
предложено: предложено
который: которую которое которыми котором которым
динофлагеллятные: динофлагеллятные
понять: понять
образ: образом образу образ
вуз: вузах
годах: годах
фрагмент: фрагмента
перемычка: перемычками
увеличивать: увеличивать
например: например
кавалье: кавалье
многоклеточность: многоклеточность
микротрубочки: микротрубочки
скелет: скелеты скелет
представленный: представлена
фактически: фактически
изображение: изображение
великобритания: великобритании
средиземного: средиземного
современный: современных современные современным современной современная современными
реконструировать: реконструировать
своеобразный: своеобразные своеобразную
вероятный: вероятно
воротничковые: воротничковые
определенный: определенный
супергруппу: супергруппу
поглощение: поглощения
отдельный: отдельно отдельная
сам: самое
аббревиатурный: аббревиатурное
ткань: тканями
подробность: подробностей
симпсон: симпсон
анализ: анализ анализе
подробнее: подробнее
примыкать: примыкает примыкают
малавимонады: малавимонады
сложность: сложность
выработать: выработать выработали
исходный: исходно
следовать: следует
известный: известная известные известны известно
каждый: каждой
регулярный: регулярно
кишечник: кишечнике
остановиться: остановиться
микроскопия: микроскопию
генерировать: генерирует
роджер: роджер
единый: единую единой
появиться: появились
необычный: необычные необычным
пунктир: пунктиром
опистоконтам: опистоконтам
нарисованы: нарисованы
менять: меняло
тот: той
вести: ведут
получиться: получилось получилась
грибоподобные: грибоподобные
признаваться: признаваться
сестринский: сестринскую сестринской
пелликула: пелликула
малоизвестный: малоизвестных
составление: составления
зооспор: зооспор
ближайший: ближайшем ближайшими
дискобам: дискобам
бороздка: бороздка бороздки
эмбриогенеза: эмбриогенеза
переслать: перешли
сыграть: сыграл
сзади: сзади
вызывать: вызывает
увеличиваться: увеличивается
самостоятельный: самостоятельных
состоять: состоит
порядок: порядка
амебозоев: амебозоев
толстый: толще
серия: серия
тип: типы типа
сокращение: сокращение
посмертный: посмертно
новый: новые новых новая новый
эвглена: эвглена
способность: способность
перечислены: перечислены
колоссальный: колоссальной
среди: среди
проявляющие: проявляющие
эуглифидная: эуглифидная
подряд: подряд
худший: худших
отделаться: отделаешься
тонкий: тонкие
эукариотной: эукариотной
двужгутиковых: двужгутиковых
центрохелидных: центрохелидных
знакомая: знакомые
располагаясь: располагаясь
ложноножки: ложноножки
водород: водород
язык: языке
система: системы система системе систему
солнечников: солнечников
третий: третья
проблемный: проблемных
внутриклеточная: внутриклеточная
смит: смит
статья: статьи статье
интересоваться: интересуется
отмечена: отмечена
питаться: питаются
место: месте местом
отвергать: отвергает
состоящими: состоящими
диатомовые: диатомовые
явный: явно
гарсия: гарсия
специалист: специалист
полный: полный
симбиогенеза: симбиогенеза
обыкновенный: обыкновенная
корень: корня корень корней корню
образовать: образуют
обведена: обведена
сравнить: сравнили
центральный: центральная
объявить: объявил
подобный: подобно подобной подобны
экскаваты: экскаваты
последовательность: последовательности
изображенный: изображенный
фораминиферы: фораминиферы
клеточный: клеточной клеточная клеточное
систематический: систематическое
получаться: получается
план: планы
такой: таких таким таком такими такого
образуя: образуя
осборна: осборна
переход: перехода переходом
красный: красные красных красным
оставаясь: оставаясь
освоить: освоили освоить
метамонад: метамонад
молекулярный: молекулярно молекулярную молекулярный
динофлагеллятной: динофлагеллятной
рассматривать: рассматривать
картина: картину
вблизи: вблизи
электронный: электронную
гипотеза: гипотезы гипотеза гипотезой гипотезу
оомицет: оомицет
классически: классически
ньяса: ньяса
вопрос: вопросов вопроса вопрос вопросом
сплошь: сплошь
время: временем
логичный: логично
знать: знаем знали
микрофиламенты: микрофиламенты
птичий: птичьего
делившая: делившая
нарисованное: нарисованное
означать: означает
объединённый: объединены
множество: множества
атрибут: атрибутов
одну: одну
гиардии: гиардии
главное: главным
гипермастигины: гипермастигины
ученые: ученые
любой: любом
эндрю: эндрю
внимание: внимание
состоящая: состоящая
чрезвычайный: чрезвычайно
изменение: изменения
результат: результате
потерявших: потерявших
небольшой: небольшая небольших
эукариотам: эукариотам
мозаика: мозаику
эукариотом: эукариотом
панцирь: панцирь
малавимонад: малавимонад
движение: движения
разница: разница
появление: появление появления
наглядный: наглядное
отгоняющий: отгоняющий
симпсоном: симпсоном
сторона: сторону стороне стороны стороной
обзор: обзор
нелепый: нелепое
гетеротрофным: гетеротрофным
работа: работы работе
спинной: спинную
множественный: множественному
микробиолог: микробиологов
формальном: формальном
американский: американского
топологии: топологии
устройство: устройству
пример: пример
эвглене: эвглене
вошедшие: вошедшие
заднежгутиковые: заднежгутиковые
представитель: представителях представители представитель
оомицеты: оомицеты
пристроенной: пристроенной
истина: истины
этап: этапе этапы
объединявшего: объединявшего
пресноводный: пресноводные пресноводных
приблизительный: приблизительно
многоклеточный: многоклеточными многоклеточные многоклеточных многоклеточное
оговорка: оговорками
мегагруппу: мегагруппу
разнообразие: разнообразие
большинство: большинство большинстве
понимание: понимания
существ: существ
представление: представлений представления
конец: конце концов конца
старый: старых старую
большой: большой
апузомонады: апузомонады
организация: организации
симпсона: симпсона
другой: другом другим
эвглены: эвглены
экскават: экскават
качество: качестве
сохранение: сохранение
объект: объекты
достаточный: достаточно
класть: кладу
целый: целом
лопес: лопес
воплощавшие: воплощавшие
бодо: бодо
эукариотного: эукариотного
твердые: твердые
примерно: примерно
намного: намного
хлоропластов: хлоропластов
картинка: картинка
отличие: отличие
положение: положение положения
упоминавшиеся: упоминавшиеся
нужный: нужны
пять: пяти
бактерия: бактерий бактерию
исходить: исходим
журнал: журнале
объединяться: объединяются
мегастволов: мегастволов
первичный: первичного первичные
эволюционировать: эволюционировали
спорить: спорили
возникнуть: возникла возникли возникло возникнуть
причем: причем
оставлять: оставляют
провести: провела
случайный: случайно
пищевой: пищевых пищевые
эндосимбиоза: эндосимбиоза
споровиков: споровиков
охарактеризованная: охарактеризованная
генри: генри
невелико: невелико
состав: состав составе
гораздо: гораздо
растение: растения растений растениями растение растениям
ответ: ответа
построение: построение
вроде: вроде
вдоль: вдоль
частить: части
фотосинтезу: фотосинтезу
митохондрий: митохондрий
испанский: испанских испанские
опубликованной: опубликованной
фотосинтеза: фотосинтеза
удивительный: удивительно
брюшной: брюшной
взято: взято
ил: иле
внутри: внутри
латинизированное: латинизированное
реализован: реализован
связаны: связаны
ядро: ядро ядра
хлоропласты: хлоропласты
маленькая: маленькие маленькая
ствол: стволов
вентральная: вентральная
общий: общий общего общих общую общее общая общим
сайт: сайта
инфузория: инфузории инфузорий инфузория
показать: показал показало
прокариоты: прокариоты
облик: облик обликом
синхронный: синхронно
вид: виде вид видов
природа: природу природы
потерять: потеряли
жгутиконосца: жгутиконосца
примитивный: примитивные примитивном примитивных примитивными
коллодиктионид: коллодиктионид
предварительный: предварительный
вывод: вывод выводы
нуклеотидные: нуклеотидные
ползти: ползти
невероятный: невероятной
совершенный: совершенно
коллодиктиониды: коллодиктиониды
перемена: перемене
открытый: открыт открытый открыто открытым
остается: остается
числиться: числятся
переходный: переходные переходной
складываться: складывались
склонный: склонные
перечисленные: перечисленные
рассмотрение: рассмотрении
скольжение: скольжении
уровень: уровень
царство: царства
золотистый: золотистые золотистая
позволять: позволяют
интересный: интересных интересны интересно
воротничковых: воротничковых
находиться: находиться находятся
водоросль: водоросли водорослей водоросль водорослям
проводящего: проводящего
одноклеточный: одноклеточных одноклеточные одноклеточными одноклеточная одноклеточным одноклеточному
учебный: учебные
сферической: сферической
итог: итоге
имевшим: имевшим
выглядеть: выглядел выглядит
воротничковый: воротничковый
показавшее: показавшее
транскриптомы: транскриптомы
никто: никто
жгутиконосцы: жгутиконосцы
автор: авторы
встречаться: встречаются встречается
описать: опишем
полезный: полезными полезно
живой: живых живую живой
вместе: вместе
привел: привел
простой: проста
относящихся: относящихся
судя: судя
зависимость: зависимости
рубеж: рубежу
основы: основы
возможность: возможности
очевидный: очевидно
боковых: боковых
организм: организмам организмами организмах организмы организме
древние: древних
укрепленная: укрепленная
тема: тема
мегагруппе: мегагруппе
включающие: включающие
дело: дело деле
жизнь: жизни
название: название названия названий названием
предполагать: предполагает
томас: томас
супергрупп: супергрупп
фотосинтезирующие: фотосинтезирующие
обновлять: обновляет
термит: термитов
амебы: амебы
друг: друг другу
касаться: касается
состоявшим: состоявшим
особый: особом
анкиромонадами: анкиромонадами
амеба: амеба
коллега: коллеги
гомологична: гомологична
отличаться: отличалась
использовать: используют
следующий: следующим
достигнуть: достигла
филогенетическое: филогенетическое
какой: какую каком какие каких каким
последовательный: последовательных
основа: основой
группа: группа групп группу группы группой группе группах
типичный: типичные типичном типичной типичная
породив: породив
дно: дна дне
инерция: инерция
эукариотная: эукариотная
трихомонады: трихомонады
полноценный: полноценном полноценной
отсутствовать: отсутствует отсутствуют
предполагаться: предполагается
указывать: указывают
вполне: вполне
ранее: ранее
жгутиковыми: жгутиковыми
слизевиков: слизевиков
меря: мере
чудо: чудом
конвергенция: конвергенции
споровики: споровики
нарисована: нарисована
выйти: вышли вышла
независимый: независимо
гребущие: гребущие
сеть: сеть
тело: тела тело телами
крайний: крайне
компактный: компактную компактных
уникальный: уникальных уникальна
нанесены: нанесены
окончательный: окончательно
накопление: накопления
цианобактерий: цианобактерий
вторичный: вторичные вторичных
говорить: говорить
нефотосинтезирующих: нефотосинтезирующих
столько: столько
остальное: остальных
миро: мире
должный: должны
выглядящий: выглядящее
странный: странно
разделиться: разделились
мощнейший: мощнейших
цианобактериального: цианобактериального
выделенный: выделена
выясниться: выяснилось
корешок: корешками
прокариот: прокариот
собирать: собирать
фигурировать: фигурирует
море: моря
подтвердить: подтвердила
распадаться: распадается
миксомицета: миксомицета
супергруппа: супергруппа
недавний: недавнее
сеять: сей
поглотить: поглотил
правда: правда
родственник: родственник родственники родственниками
соответствовать: соответствует
увеличение: увеличение
замечательный: замечательной
входить: входят входит
вентральной: вентральной
желтозеленые: желтозеленые
оперившимся: оперившимся
курс: курсы
почвенный: почвенных
разный: разных разному
вымерший: вымершие
называться: называлось называется называются
разнообразный: разнообразные
молекула: молекулами
неизвестный: неизвестные
оккама: оккама
жизненный: жизненную жизненного
утверждать: утверждать утверждают
исследовать: исследовать
гетеротрофных: гетеротрофных
