детектор: детекторами детекторы детектор детектора детектору детектором детекторов
блазарах: блазарах
вода: воды водах воде водой воду
проработать: проработал
ставка: ставка
многокилометровой: многокилометровой
следовать: следует
свой: свой своим
констатация: констатацией
нейтринных: нейтринных
элементарный: элементарные
фон: фона
фото: фото
нацеленный: нацеленный
шаг: шаги
морской: морском морской
фотоумножителями: фотоумножителями
выстрелить: выстрелил
лететь: летят летел летит
полный: полный
упустить: упустим упустить
терять: теряет
посчастливиться: посчастливится
окно: окне
связь: связи
частица: частица частицы частиц частицами
весь: всей
улавливая: улавливая
гэв: гэв
расчеты: расчеты
смотреть: смотрит
байкал: байкал
прилетать: прилетают
отчитаться: отчиталась
понимать: понимать
сжатый: сжаты
противоречие: противоречие
оказаться: оказался окажется
насквозь: насквозь
астрофизических: астрофизических
откуда: откуда
обходиться: обходится
удаление: удалении
важнейший: важнейший
испущенный: испущенный
пролетевшее: пролетевшее
прилетевшим: прилетевшим
принцип: принципе
оставаться: остаются оставались
коллаборация: коллаборация
другой: другом
средиземного: средиземного
исключительный: исключительно
трехкилометровую: трехкилометровую
небо: неба небе
пролететь: пролетел
кодовый: кодовое
нейтринной: нейтринной
модуль: модулями модулей модули модуль
примерно: примерно
предсказать: предсказать
достижение: достижения
направление: направление направлении направлением направлению направления
нейтринному: нейтринному
микрофон: микрофонами
благодаря: благодаря
ограничиться: ограничиться
уметь: умеют
причем: причем
пролетающими: пролетающими
сеять: сей
оказываться: оказывается
появиться: появились
исследование: исследований исследования
понятный: понятно
угодить: угодил
допустимый: допустим
невиданный: невиданной
аномальный: аномально аномальных
оценивать: оценивала
сильный: сильно сильнее
потеря: потерь
вавилова: вавилова
сообщать: сообщала
проследив: проследив
глобальный: глобальной
ограничившись: ограничившись
оставить: оставим
найтись: нашлось
теоретик: теоретики
короткий: короткой короткий
путешествие: путешествии путешествия
неподвижный: неподвижного
показана: показана
наблюдать: наблюдает наблюдать
метода: методами
умеренный: умеренной умеренно
строить: строить
сторона: стороны
ответ: ответа
нескольких: нескольких
медленный: медленнее
последний: последние последних
теоретически: теоретически
чиркнуть: чиркнуло
считанные: считанные
дело: дело
возможный: возможно
узнать: узнать
запастись: запастись
грунт: грунт грунта
огромный: огромный огромных огромной
пролетающего: пролетающего
оценить: оценить
экстремальных: экстремальных
коллаборации: коллаборации
заполнить: заполнить
готовить: готовят
половина: половиной
конкретно: конкретно
выполнить: выполнили
бывать: бывают
сложность: сложности сложность
расстояние: расстояние расстояниях расстоянии расстояния
юг: югу
газопылевыми: газопылевыми
объемем: объемем
который: которое
орионом: орионом
квазар: квазаров
поэтому: поэтому
атмосфера: атмосфере атмосферы
растет: растет
оборудован: оборудован
скромный: скромной скромных скромного скромным
поток: потоки поток потоком потока
сверху: сверху
зарегистрированный: зарегистрирована зарегистрировано
изображение: изображение
уставать: устают
джаявардхана: джаявардхана
свойство: свойства
нейтринного: нейтринного
фотоумножителей: фотоумножителей
исследовательский: исследовательского
колыхать: колышут
достоверность: достоверности
пёс: псом
годах: годах
бежевый: бежевая
экспозиция: экспозиция
взять: взять
заэкранировать: заэкранировать
поимка: поимки
байкальский: байкальского
маловероятно: маловероятно
обязательный: обязательно
выдающийся: выдающегося
худой: худой
синий: синий
прозорливый: прозорливом
касательный: касательной
приводить: приводит приводят
звездами: звездами
преподнести: преподнесли
загадка: загадкой загадки загадке
раз: разу раза
лёд: льда льду льдах
двигаться: движется
дополнительный: дополнительную
запад: запада
родиться: родились родился родилось
учеными: учеными
астрофизике: астрофизике
намного: намного
основа: основу
магнитный: магнитными
одним: одним
опыт: опыт
метр: метров
ливень: ливнем
журнал: журнале журнал журнала
одну: одну
соседний: соседними
засветить: засветил засветили засветило
треть: трети треть
сопоставление: сопоставление
подробность: подробности подробностей
эйфелева: эйфелева
далекий: далекий
практически: практически
неспокойный: неспокойном
фотоумножители: фотоумножители
случайный: случайно
стрелять: стрелять
мыслить: мысли
судя: судя
нашить: нашей
достигать: достигают достигает
работающее: работающее
исключено: исключено
полутора: полутора
менять: менять
день: дней
ссылка: ссылки
охота: охоты
порожденный: порожденный
единственный: единственное
уловить: уловили
начаться: начались началась
средиземном: средиземном
поздний: поздние
сириусом: сириусом
известный: известных известными
закреплены: закреплены
ледник: ледника
идти: шло
войти: вошла
регистрировать: регистрируют регистрируем регистрирует
обсуждаемой: обсуждаемой
установка: установке установка установку установки установок
строиться: строиться
превратившееся: превратившееся
поставиться: поставило
подводный: подводный подводного
крайний: крайней
складываться: складывается
избавиться: избавиться
улавливать: улавливать улавливают
эксперимент: эксперименты
состояние: состоянию состояния
инфографику: инфографику
полностью: полностью
раскрытый: раскрытые
свободный: свободны
сиреневый: сиреневые
чувствовать: чувствуют
позволять: позволяет
беспрецедентный: беспрецедентно беспрецедентное
ясный: ясно
дух: дух
прилетающие: прилетающие
ультразвуковые: ультразвуковые
звуковой: звуковой
пронзить: пронзило
километр: километрах километр километра километров
своем: своем
распространяющегося: распространяющегося
работавших: работавших
лето: летом лету
видимый: видим
объема: объема
прорыв: прорывом
испущенные: испущенные
мочь: можем могли могло
рекордный: рекордного рекордное
скорость: скоростью скорости
охотник: охотники
ярка: яркой
прицел: прицелом
сентябрь: сентября сентябрь
минус: минус
установить: установить
найдено: найдено
размер: размеры размером размеров
восток: восток
включая: включая
нейтринная: нейтринная
сработавших: сработавших
опираясь: опираясь
объяснение: объяснение
поглощение: поглощения
требоваться: требуются требуется
развернет: развернет
обязанный: обязано
карта: карте
фронт: фронт
подводить: подводит
подобный: подобных подобные
засветку: засветку
главный: главная
атом: атом
указывать: указывают указывали указывать
конец: конце конец
годы: годы
предпринимались: предпринимались
далеки: далеки
многокилометровую: многокилометровую
луна: луна луны луну
снизу: снизу
последующий: последующие
связать: связал
недешевое: недешевое
удерживаться: удерживается
испущенного: испущенного
совершенный: совершенно
понято: понято
шутка: шутка
длительность: длительность
летящего: летящего
либо: либо
несомненный: несомненно
февраль: февраля
путь: пути
безумный: безумно безумных безумные
отстает: отстает
развертывание: развертывание
работать: работать
выполняться: выполняются
расположенный: расположен
записывать: записывает
поблизости: поблизости
опубликована: опубликована
проект: проект проекту
добиться: добилась
вопрос: вопрос вопросы
четко: четко
прямой: прямо прямой
берег: берег берегов берега
щит: щита
подробнее: подробнее
учетом: учетом
излучатель: излучатели
крест: крест
расчете: расчете
попытаться: попытался
сверхразвитой: сверхразвитой
среда: среде
пьера: пьера
давать: давайте
быстрый: быстрее
поглощаться: поглощаются поглощается
первый: первые первым первых первая первое
работа: работа работ работы
след: следам
сравнение: сравнению сравнения
начать: начало начал
катастрофического: катастрофического
забитый: забит
синхронный: синхронно
мюонную: мюонную
признать: признать
трудный: трудно
новый: новых новый нового
колыхаться: колышутся
подавляющий: подавляющее
освещенной: освещенной
поскольку: поскольку
созвездие: созвездии
отодвинуться: отодвинуться
звездочки: звездочки
обнаружиться: обнаружилась
прошедший: прошедший
происходить: происходит
элемент: элементов элемент элементы
взаимодействие: взаимодействии взаимодействия
найти: найти нашли
налоговый: ого
всевозможный: всевозможных
вероятность: вероятность
порождать: порождают порождать
проблема: проблема
используется: используется
точка: точки точка
двигаясь: двигаясь
данные: данные данных
пустой: пустое пустых
свечение: свечения
разлетаться: разлетаются
окончательный: окончательно
область: области
моделирование: моделирование моделированием
распад: распаде
лучить: лучи
вмораживаться: вмораживаться
пролета: пролета
представить: представить
добавить: добавить
громкий: громкое
большой: большой большом большого
галактика: галактики галактике галактик
действующий: действующие
интерпретация: интерпретации
рисковать: рискуем
ледниковый: ледникового
космогенными: космогенными
столкновении: столкновении
преобразоваться: преобразуется
заряд: заряда
взвешенный: взвешенного
полученная: полученная
история: историю
увидеть: увидеть увидел
удивлять: удивлять
толк: толком
крыться: кроется
результат: результат результаты результате
оценивались: оценивались
тестировать: тестировала
ломать: ломают
произойти: произошло произойти
приходить: приходят приходит
технология: технология
цивилизация: цивилизации
фотон: фотоны фотонами
засветке: засветке
удобный: удобен
импульс: импульс
насколько: насколько
сталкиваться: сталкиваться
вошедшее: вошедшее
небесный: небесной
глубинный: глубинные
падать: падает
чувствительный: чувствительной чувствительные чувствительный чувствителен
неизвестный: неизвестно
рассматривать: рассматривать
продолжаться: продолжается
наносекунд: наносекунд
одновременный: одновременно
буйный: буйных
земля: землю земли
маленький: малы мала
цвет: цвет
координаты: координаты
превратившегося: превратившегося
слово: словом
трудность: трудности
касаться: касается
близкий: близких близкого
исполинский: исполинская
космос: космоса космос
сверхвысоких: сверхвысоких
электромагнитный: электромагнитных
волна: волн
диаметр: диаметром
середина: середину
вакуум: вакууме
прочий: прочих
прочитать: прочитать
повезти: повезло
вырваться: вырвалось
гонка: гонку
установленный: установлена установлено установлены установленной
рекордсмен: рекордсмена рекордсмен рекордсменов
обозначение: обозначение
свыше: свыше
удивительный: удивительные
поначалу: поначалу
обратить: обратил
рассуждение: рассуждение
прошить: прошить
видеть: видит видеть
добавление: добавления
зажатом: зажатом
зарегистрировать: зарегистрировать зарегистрировал
неприметный: неприметном
медуза: медуза
вступать: вступает
микросекунды: микросекунды
информация: информацию информация
обсудить: обсудим
ожидаться: ожидается
средний: среднее среднего
дальний: далее
относительный: относительно
объявление: объявлением
пролетать: пролетал
каталог: каталогам каталоги
вспышка: вспышкой вспышки вспышек вспышками вспышка
составлять: составлять составляет
пэв: пэв
астрофизика: астрофизика
родившийся: родившиеся родившийся
прийтись: пришлось
фиолетовый: фиолетовым
данный: данном
пойманное: пойманное
вертикальный: вертикальными вертикальных вертикальном вертикально
физика: физики физике физикам
вестись: вестись
судный: судна
падавшими: падавшими
выясниться: выяснилось
коллектив: коллективу
тень: тень тени
срабатывать: срабатывали
вторичный: вторичные
прилететь: прилетело
осветить: осветил
крепиться: крепились крепится
увеличиваться: увеличивается
анализ: анализ
придонных: придонных
пройти: пройти
стрелок: стрелками
запаздывание: запаздывание
район: районе
развитие: развитие
превращение: превращений
статистический: статистический статистическая
завершение: завершения
градус: градуса градусов
прятаться: прячется
очередной: очередной очередную
анализировать: анализировала
месяц: месяцев
никакой: никакие никаких никакой никакого
прилетающим: прилетающим
черными: черными
течение: течения течение
рождение: рождения
далекие: далекие
устанавливаться: устанавливаться
дешёвый: дешевле
оценка: оценке оценку оценок оценки оценка
придонное: придонное
дочерний: дочерний
внеземной: внеземной
внегалактический: внегалактических
разниться: разнятся
отсутствие: отсутствием
смазанной: смазанной
обоих: обоих
спустя: спустя
серьезную: серьезную
марк: марк
смещая: смещая
потенциальный: потенциально
временный: временном
сопровождающий: сопровождающие
передать: передали
наблюдательный: наблюдательных
закручиваться: закручивается
температура: температура
источник: источник источники источника источников источниками
иной: иными
километровый: километровой километровых километрового километровый
солнечный: солнечные
объявить: объявила
инженер: инженерам
годичный: годичный
отбросить: отбросить
плюс: плюс
доселе: доселе
вначале: вначале
ловить: ловить ловим ловит
значительный: значительная
открытый: открытом
энергия: энергией энергию энергии энергий энергия энергиями энергиях
место: место местах
масштаб: масштаба масштаб масштабах масштабов
смочь: смог смогли
расходиться: расходится
упавший: упавшие
голова: голову
вселенную: вселенную
рождаться: рождается рождаются
энергичный: энергичные
конус: конус конусом
поиск: поиски поисках
отличать: отличать
ориона: ориона
простор: просторах
присвоено: присвоено
никак: никак
мощный: мощное
переведем: переведем
попадание: попадании
ограничение: ограничения ограничение
склоняться: склоняются
предыдущий: предыдущего предыдущих предыдущий
гораздо: гораздо
показать: показала
сорт: сортов сорт
материя: материи
гамма: гамма
этап: этапе
корректный: корректной
незамеченным: незамеченным
измерив: измерив
сообщить: сообщила
сотня: сотни сотне сотен сотню
представленный: представлены
глаз: глаза глазами
предоставить: предоставить
рождающихся: рождающихся
развертыванию: развертыванию
достоверный: достоверно достоверной достоверное
контролируется: контролируется
реконструировать: реконструировать
траектория: траектория траектории траекторию
водоросль: водоросли
порядок: порядки порядка
поймать: поймали поймать поймал
энергопотери: энергопотери
моментальный: моментально
расклад: раскладам
земной: земной земного
ранний: раннюю ранние
строящегося: строящегося
обе: обе
уровень: уровне
сфера: сфере
какой: какую какого каких какое
спокойный: спокойного спокойных спокойные
ударный: ударных
пионерский: пионерские
доказать: доказал
участок: участок
реальный: реальным
испускать: испускает
регистрация: регистрации регистрация регистрацию
приход: прихода
теоретический: теоретические
хотеться: хочется
некоторые: некоторые
блазарами: блазарами
трос: тросов тросы тросами троса
несущий: несущих
лунный: лунная
группа: групп
отслеживать: отслеживать
знать: знать знаем
соответствовать: соответствовали соответствовать
предъявить: предъявят
сверхсветовой: сверхсветовой
никто: никто
нейтринном: нейтринном
луч: лучах лучей
франция: франции
стоять: стоит
сюда: сюда
серый: серая
остается: остается
ничем: ничем
значение: значение
электрический: электрического
посылать: посылают посылает
сразу: сразу
меря: мере
глубокий: глубокого глубокий глубоко
дно: дне дну
размещены: размещены
случать: случаем
яркость: яркость
факт: факта
несказанно: несказанно
подходящий: подходящие подходящих
выделиться: выделилось выделится
страница: страницу страница
далекого: далекого
сам: самое
объект: объектов
существенно: существенно
сверхвысокой: сверхвысокой
широкий: широко широкой широким широкие
солнце: солнце солнца
адронный: адронный
помеха: помеха
трехдюймовый: трехдюймовый
техник: техника
справа: справа
описание: описание
словно: словно
долетать: долетают
атмосферный: атмосферных атмосферные атмосферными атмосферный
занятие: занятие
сто: сто
излучение: излучения излучение
разный: разных
отдельный: отдельные
заметный: заметные
рисунок: рисунок
высадив: высадив
разогнать: разогнать
невелика: невелика
держать: держать держали
восстановленной: восстановленной
охарактеризовать: охарактеризовать
игорь: игорь
нейтринными: нейтринными
единорог: единорога
пояс: пояса
катастрофа: катастрофы
уголок: уголке
прилет: прилета
безнадежное: безнадежное
открывая: открывая
фейерверк: фейерверк
большинство: большинство
растратить: растратил
направить: направила
катаклизм: катаклизмов катаклизм
рекорд: рекордом рекорд
механизм: механизм
годов: годов
убедиться: убедиться
телескоп: телескопе телескоп телескопа телескопами телескопов телескопы телескопу телескопом
сигнал: сигналы сигнал сигналом сигнала
межгалактический: межгалактическом межгалактической
сверх: сверх
полученный: полученный
боуэн: боуэн
средиземноморский: средиземноморские средиземноморских
нулевой: нулевые
посторонний: посторонних
планомерно: планомерно
конечный: конечном
ускорительный: ускорительной
увеличить: увеличить
прозвучать: прозвучало
нетрудный: нетрудно
вернемся: вернемся
полюс: полюсе
непростой: непростое
называть: называть называют
сеанс: сеанс
основание: основании
увы: увы
рис: рис
подчеркнуть: подчеркнуть
минута: минут
полпути: полпути
приходиться: приходится
указать: указать
сайт: сайте
превышающих: превышающих
рассеиваться: рассеиваются
постоянный: постоянно
десяток: десятки десятка десяток десятков
гигантский: гигантский
открытие: открытие открытия открытии
создание: созданию
опубликованный: опубликованный
ошибка: ошибку
пространство: пространстве
отлажена: отлажена
вид: виде виду
последовательный: последовательно
полученные: полученные
причина: причина
цепочка: цепочек
стать: стало стали станет
осцилляций: осцилляций
заряженный: заряженные заряженных
наблюдаться: наблюдаются
предсказывать: предсказывают
наумов: наумов
например: например
фасеточные: фасеточные
важный: важно
специалист: специалисты
распространяться: распространяется
рожденное: рожденное
успешный: успешная
контролем: контролем
толща: толщу
пресс: пресс
нобелевский: нобелевская
полноправный: полноправным
спуск: спуску спуск
равный: равно равной
исследователь: исследователи
пар: пара пару
рожденных: рожденных
глава: главы
помогать: помогает
обнаружить: обнаружить обнаружил
удаленные: удаленные
конкретный: конкретный конкретного
котловина: котловины
фотоумножитель: фотоумножитель
просматривать: просматривать
добрый: добрый добрую
точность: точностью
параметр: параметр
реальность: реальность
момент: момент момента
число: числе
датчик: датчиков датчиками датчики
условие: условия условиях
лед: лед
определимый: определим
больший: большим большего
протон: протоны
гирлянда: гирлянд гирляндами гирлянду гирлянда гирлянды гирляндой
накопить: накопить
общий: общую
конференция: конференции конференциях
массы: массы
поверхность: поверхности
электрон: электронами
положение: положении
столкновение: столкновение
способный: способно способны способными способный способна
башня: башня
фантастам: фантастам
положить: положили
появляющиеся: появляющиеся
критический: критически
приводиться: приводятся
остаться: осталось
оптический: оптическими оптических оптические оптический
вихревое: вихревое
десяти: десяти
сравнив: сравнив
распределение: распределение
красный: красные
сквозь: сквозь
такой: таких такого такими таким
южный: южном
сомнение: сомнения сомнений
готовый: готовые
слабый: слабом слабый
взрыв: взрывов
ядро: ядрах ядер
побившее: побившее
писатель: писателям
превышать: превышает превышают
космический: космическое космические космических космический
подпроект: подпроект
звездных: звездных
престижный: престижный
отклоняться: отклоняются
молекула: молекулами
озеро: озера
добавлять: добавляют
последовательность: последовательности
космологический: космологические
высокий: высокой высоко выше
среди: среди
предел: пределы
крестик: крестики
накопиться: накопилось
долгожданный: долгожданным
виновник: виновнику
заросль: заросли
прозрачный: прозрачной
поздно: поздно
буй: буем
минимум: минимум
посмотреть: посмотреть
астрофизические: астрофизические
экспериментатор: экспериментаторам
посвященная: посвященная
мюон: мюон мюонами мюона мюоны мюонов
участвовать: участвуют
особняк: особняком
удается: удается
позволить: позволила позволило
порождено: порождено
засветившие: засветившие
поле: полями
блокироваться: блокируются
обещая: обещая
миллион: миллионы
астрофизического: астрофизического
петаэлектронвольт: петаэлектронвольт
превратиться: превратилось
звезд: звезд
надежно: надежно
популярный: популярного популярном популярное
вселенная: вселенная
облако: облаками
прямехонько: прямехонько
ситуация: ситуация
предполагаемый: предполагаемая
процесс: процессов процессы
нести: нести несут
обсерватория: обсерватории обсерватория
горячить: горячим
синопсиса: синопсиса
желтым: желтым
попадать: попадает
иначе: иначе
отслеживает: отслеживает
самый: самых самым самые
одна: одна
родительский: родительского
летя: летя
происхождение: происхождения происхождении
вступить: вступила
вблизи: вблизи
отличие: отличие
редчайший: редчайшие
поменьше: поменьше
оже: оже
тогдашний: тогдашней
конфигурация: конфигурации
кубический: кубический кубического
озер: озер
образ: образом
приходящий: приходящего
численный: численное
диапазон: диапазоне
прошерстить: прошерстить
полоса: полосы полоса
делать: делают делает
достаточный: достаточно
счете: счете
наносекундной: наносекундной
сенсационный: сенсационный
особенность: особенности
полноценный: полноценному
доля: долю
анимацию: анимацию
событие: событий событие событию события
испытать: испытало
активный: активных
правдоподобный: правдоподобной
уверенно: уверенно
блазаров: блазаров
пунктирный: пунктирные
сообщение: сообщением
сицилия: сицилии
длиться: длился
объесть: объем
случай: случае
коллайдер: коллайдер
поэтапный: поэтапно
завершенный: завершенный
приезжать: приезжает
показывать: показывают показывает
срабатывание: срабатывания
тысяча: тысячи
горизонтальный: горизонтальные горизонтально
инструмент: инструментом инструментов
мэв: мэв
далеких: далеких
заметить: заметить
работая: работая
титан: титанами
часть: часть
поколение: поколения
неторопливый: неторопливо
пытаться: пытаемся пытались
налево: налево
уловленного: уловленного
одно: одно
прошлое: прошлого
трех: трех
обслуживание: обслуживание
звук: звук
разногласие: разногласие
иванов: иванов
пультовую: пультовую
посыпятся: посыпятся
нашими: нашими
сюжет: сюжет
счастье: счастью
решетки: решетки
развертывания: развертывания
блокировать: блокирует
антарктический: антарктического антарктическом
прежде: прежде
детектив: детектива
проводить: проводила
дополняющий: дополняющий
растянуться: растянулось
небольшой: небольшом небольшой небольшим
пример: пример
нейтрино: нейтрино
канал: канал
разнообразный: разнообразных
толстый: толще толстом
несет: несет
ориентации: ориентации
сезон: сезон
премия: премия
плавучий: плавучим
контроль: контроля
тайна: тайне
внимание: внимание
движение: движения
исходный: исходного
вообще: вообще
спонтанный: спонтанных
вещество: веществом
недостаток: недостатка недостатков
ход: ходом
произвести: произвела
сенсация: сенсацию
свет: света свет свете
редкий: редкое редко
различный: различные различных
высокоэнергетическими: высокоэнергетическими
угол: угол углом
линия: линии
флуктуация: флуктуация
попытка: попытки
многообразный: многообразны
длина: длины длиной длина
гипотеза: гипотезы гипотезу
нанизанными: нанизанными
начинать: начинает
выделенный: выделенного
центральный: центральной
нейтринный: нейтринный
сработавшими: сработавшими
море: моря морей море
дыра: дырами
показаны: показаны
задержка: задержкой
выйти: вышла вышел выйти
полить: полей
внутри: внутри
научный: научная научную научных
располагаться: располагаться располагался располагались
необходимость: необходимости
приведенных: приведенных
терпение: терпением
главное: главное
вполне: вполне
тэв: тэв
нейтринные: нейтринные
абсолютный: абсолютно
неглубокий: неглубокие
вовсе: вовсе
космогенных: космогенных
новость: новость
построенный: построенный
вышедшей: вышедшей
материал: материале
мегапарсек: мегапарсек
глубина: глубины глубин глубинах глубине глубину
наткнувшись: наткнувшись
уникальный: уникальным
план: план
автор: авторы
век: веке
количество: количество количества
черенкова: черенкова
полета: полета
должный: должна должны должен
присуждена: присуждена
мартовский: мартовском
будущий: будущей
рэй: рэй
погрешность: погрешности погрешностью
вселенной: вселенной
наблюдение: наблюдения наблюдений наблюдение
несколькими: несколькими
устранять: устраняет
точнее: точнее
светочувствительный: светочувствительных
определить: определить
неверный: неверно
предположение: предположениях
статья: статья статью статье статьи
изучение: изучения
пьезоэлектрическими: пьезоэлектрическими
суммарный: суммарная
нестабильный: нестабильны
торжество: торжества
вызванный: вызванная
получиться: получиться получится
помощь: помощью
находиться: находится
тип: типа
