родич: родичи
семья: семьи
северный: северный
современность: современности
регистрироваться: регистрируется
смочь: смогли
чемпион: чемпионов
начать: начало
транспортный: транспортного транспортных
завершение: завершении
новообретенную: новообретенную
фон: фоне
кузнецова: кузнецова
пабло: пабло
условный: условное
графике: графике
вождь: вождя
название: название
спустя: спустя
шнуровой: шнуровой
подоспеть: подоспели
побольше: побольше
рукоять: рукоятью
подтвердиться: подтвердился подтвердилось
новый: новые новая новой новый новом новых
получившему: получившему
древние: древних древние
щитовые: щитовые
средний: средний средняя
который: которым которое которую
людовика: людовика
исторический: историческую исторического
резкий: резкое резко
ясность: ясности
расти: расти
зарастать: зарастала
длинный: длинных
участник: участники
косинцев: косинцев
ямников: ямников
место: мест
выдвинуты: выдвинуты
изымается: изымается
военный: военного
пржевальского: пржевальского
инновация: инновация
нижний: нижний
рекомбинацией: рекомбинацией
условие: условиями
зеленый: зеленый
различный: различные
размножаться: размножались
свойство: свойствами
развитие: развития развитие развитием
тулузе: тулузе
казахстан: казахстан казахстана
изученные: изученные
произвести: произвести
евразийский: евразийские евразийских
некоторые: некоторые
население: населении
возможный: возможно
снижение: снижение
тысяча: тысячи
качество: качестве качество
видимый: видимому видим
публиковать: публиковать
начало: начале
обитавшей: обитавшей
ямники: ямники
человеческий: человеческом человеческих человеческой
усовершенствованный: усовершенствованными
часы: часов часы
работа: работы
середина: середины середине
начиная: начиная
скрещивать: скрещивают
разный: разными разному
одичавшими: одичавшими
род: родом
иметься: имелось
репродуктивный: репродуктивного репродуктивная репродуктивном
подскочивший: подскочивший
запутанный: запутанную
второй: вторая
причерноморско: причерноморско
соседний: соседних
линия: линии
бронзовый: бронзового бронзовом
согласоваться: согласуется
взять: взять
бутылочный: бутылочным бутылочное бутылочного
привести: привело привели
основанный: основанной основана основаны основанную
российский: российские
большинство: большинства
серьезное: серьезное
демографическими: демографическими
подтвердить: подтвердили подтвердила подтвердил
отвести: отвести
практиковаться: практиковались практикуются
доместикации: доместикации
определить: определить
верховый: верховой
друг: друг
зеленеть: зеленела
климат: климат
молоко: молока молоку
являться: являются
грандиозный: грандиозного
либрадо: либрадо
доложить: доложили
крупный: крупная
отсутствовать: отсутствует
приход: прихода
сменитсья: сменилось
краткий: краткий
предок: предков предки предка
метод: методом методов
особый: особо
тарпанов: тарпанов
спица: спицами спиц
участок: участков
иначе: иначе
мочь: могли
независимый: независимые
эпохальный: эпохальной
элемент: элементах элементы
траектория: траекториями
уровень: уровнями
каменный: каменные
ботайская: ботайская
колесница: колесницами колесницы
страна: стран
трансильвании: трансильвании
порода: породу пород породы
возникнуть: возникло
наконечник: наконечники
произойти: произошла произошли
весьма: весьма
примесь: примеси примесь
ассоциированные: ассоциированные
признак: признаков признаками признаки признак
изо: изо
анализ: анализ анализа
орландо: орландо
точный: точно
минувший: минувшие
другой: другом
степной: степная
коневодство: коневодства
изученных: изученных
цвет: цвета
изученном: изученном
палеопротеомика: палеопротеомика
быстрый: быстро быстрые
каспийский: каспийских
успех: успех успехом успехам
энеолита: энеолита
оценить: оценить
спасская: спасская
огромный: огромный
молекулярный: молекулярных
претендующие: претендующие
днепр: днепром
наследие: наследие
уменьшение: уменьшение
инбридинга: инбридинга
модель: моделях
ботайской: ботайской
никакой: никакого никаких никакой
урал: уралом
прочий: прочие
центральный: центральную
прийтись: пришлось
карпатам: карпатам
ямной: ямной
западный: западная западной
образ: образом
сокращаться: сокращаться
руководство: руководством
частичный: частично частичном частичного
цель: целях
центральноевропейских: центральноевропейских
исходный: исходной
выпадать: выпадало
попытаться: попытались
исчезнуть: исчезли исчезла
учитывая: учитывая
верхний: верхний верхнем
создать: создать
пытаться: пытались
степь: степи степях степь
посвящен: посвящен
специальный: специальный
окрыленные: окрыленные
сила: сил
видеться: видится
совершенный: совершенно
погребение: погребение
основа: основе
центральноевропейскими: центральноевропейскими
гомозиготности: гомозиготности
эра: эры
предполагаемый: предполагаемые
распределяться: распределяются
автор: авторов авторы автор авторам
относящиеся: относящиеся
процентный: процентной
редкий: редкими
осадки: осадков
число: числу числа
охотничий: охотничьей
использовались: использовались
модельный: модельных
нарастить: нарастить
горизонтальный: горизонтальной
аспект: аспектов
мясо: мяса
сделанный: сделанный
оспорить: оспорили
ответ: ответ
отсутствие: отсутствие
одичать: одичали
ход: ходе
старомодный: старомодные
потомство: потомства
рис: рис
роль: роль
текст: текст
большой: большой
внятный: внятных
состоять: состояла состояло
повлиять: повлияло
дожили: дожили
размножать: размножать
приручить: приручили
контроль: контроля контроле
продолжать: продолжали
носитель: носителям носители
дон: дона
охватывать: охватывают
указывать: указывают
немногочисленный: немногочисленные
хозяйство: хозяйства
индоевропейский: индоевропейской индоевропейских
новость: новости
пропорциональный: пропорционален
таки: таки
снижаться: снижался
соотноситься: соотносится
орнамент: орнаментом
рог: рога
распространиться: распространились
эффективный: эффективной эффективного
вовсю: вовсю
поздний: позднего
дикий: диких дикой дикими дикие
последовать: последовал
небольшой: небольшая
управлять: управлять
система: систему
источник: источником источник
запрягать: запрягать
возраст: возрасте возраст
разводить: разводили разводить
июнь: июня
внешний: внешней
рука: руки
марков: марков
новоизобретенными: новоизобретенными
размер: размер
демографический: демографический
выдающийся: выдающемся
метода: метода методы метод
считаться: считаются
собственный: собственно
удается: удается
численность: численности численность
прочтенных: прочтенных
вроде: вроде
накопленных: накопленных
внедрение: внедрением
решающий: решающего
фаланга: фаланга
век: веков века веке
миграция: миграция миграции миграций
родственный: родственны
такой: таким
полный: полный полной полному
абрамсон: абрамсон
противоречие: противоречия
появиться: появились
связано: связано
ускоренный: ускоренного ускоренно
сокращение: сокращению сокращение сокращения
хорватия: хорватии
великобритания: великобритании
провал: провал
кузнец: кузнецов
производство: производство
пробел: пробелы
тысячелетие: тысячелетия
обычный: обычными
помесь: помесью
природа: природа природе
география: география
возражение: возражения возражение
езды: езды
боле: боле
наших: наших
культура: культур культура культуры культуре культурой
попытка: попытка попытки
целый: целых
шести: шести
общество: обществ
вариант: варианта
обнаружены: обнаружены
животное: животных
рассказано: рассказано
охват: охват
ценнейший: ценнейшую
массив: массиве
родня: родней родня
движение: движение
кластер: кластеру кластерам кластеры
вывести: вывели
масштаб: масштаб
показать: показали
стать: стали стать стала
палеогенетике: палеогенетике
значительный: значительная
поэтому: поэтому
ботайцев: ботайцев
скакать: скакать
следующий: следующим
одному: одному
волга: волги
мутация: мутаций мутации
последний: последние
исключать: исключают
выведены: выведены
западнее: западнее
оранжевый: оранжевый
медный: медный
длительность: длительности
проект: проекта
конец: конца конец концу
изображение: изображение
предыдущий: предыдущие
археолог: археологи
произошедшая: произошедшая
каждый: каждом
климатический: климатическими
решить: решили
обсуждаться: обсуждались
прийти: пришли
отладить: отладили
показано: показано
обитавших: обитавших
количество: количество
торговля: торговли
живших: живших
особа: особой
связывать: связывают
отсеквенировать: отсеквенировать
мутационные: мутационные
сделать: сделали
франция: франция франции
интервал: интервал
праиндоевропейскому: праиндоевропейскому
обнаружить: обнаружить
нынешний: нынешнего
исследователь: исследователи
предположительно: предположительно
одомашнены: одомашнены
мнение: мнению
самый: самых самые
исследование: исследования исследовании
принадлежать: принадлежат
безлошадный: безлошадными
скрещивание: скрещивания скрещиваний
стараться: стараются
больший: больших
меря: мере
критический: критическому
участие: участия
тарпаны: тарпаны
недавний: недавнее
статья: статьи статье статья
вывод: вывод выводам выводы
последующий: последующих последующий
изобретенными: изобретенными
придумать: придумали
период: периода период
северо: северо
ботайские: ботайские
современный: современным современные современных
древнейший: древнейших
европа: европе европу
вдвое: вдвое
гипотеза: гипотезу гипотеза
международный: международного
генетический: генетически генетическому генетическим генетическое
вместе: вместе
обзор: обзор
соответствовать: соответствуют
присутствие: присутствие
рекомбинационные: рекомбинационные
последствие: последствий
поселение: поселении
вымереть: вымерли
особь: особей
мейоз: мейоз
служить: служили
копия: копий
рост: рост росту
детальный: детальные
тяжелые: тяжелые
степняк: степняков степняки
поколение: поколения поколениях поколений поколении
энеолитической: энеолитической
опубликован: опубликован
вклад: вклад
день: дней
меч: мечом
начинаться: начинается
целиком: целиком
ранний: раннем ранняя ранний
язык: языка
динамика: динамику динамика
ботайских: ботайских
часть: часть
обсуждение: обсуждению
возникать: возникает
степень: степени
серьезным: серьезным
связать: связала
журнал: журнала
ученые: ученые
среднедунайской: среднедунайской
ассоциированных: ассоциированных
создатель: создателями
загон: загонах загоны
применить: применили
популяция: популяции популяциях популяция
близкий: близки близкой близких близкого
выпуск: выпуск
сам: самое
многие: многих
продолжительность: продолжительность
идея: идее
артефакты: артефакты
ценный: ценных ценными
тезис: тезисы
разнообразный: разнообразны разнообразных
явный: явные
очевидный: очевидно
камень: камне
домашние: домашних домашним домашние домашними
использование: использования
скорый: скорее
рисунок: рисунок
график: график
испытать: испытали
загонять: загоняли
прикаспийской: прикаспийской
вытеснив: вытеснив
выведение: выведении
группа: группе группы
деятельность: деятельности
изобилие: изобилие
кобылий: кобыльего
сообщать: сообщают
основный: основные
палеогенетические: палеогенетические
низменность: низменности
позволить: позволил позволило позволили
одомашнивание: одомашнивания одомашнивание одомашниванию
бурный: бурный
университет: университета
приводиться: приводились
уточнить: уточнить
евразия: евразии
сравниваться: сравнивались
россия: россии
благоприятный: благоприятными
наподобие: наподобие
очередной: очередного
гастрономический: гастрономических
формирование: формирование
предоставление: предоставлении
датированы: датированы
обособление: обособления
интерпретировать: интерпретировать
этап: этапа
близкородственный: близкородственные близкородственных
ровный: ровно
сторона: стороны
человек: людей людям
масштабный: масштабная
языковый: языков
полторы: полторы
показатель: показатель
глобальный: глобальная
александр: александр
результат: результаты результате результат
потомок: потомками потомков
опубликованной: опубликованной
вымерший: вымерших
равномернее: равномернее
вероятный: вероятно
вероятность: вероятность
край: краях
сопровождаться: сопровождалось
получить: получила получить
первый: первой первые
европеец: европейцев
испания: испании
географический: географический
добыча: добычей добыче
видный: видно
палеогенетика: палеогенетика
бык: быками
след: следов следы
существование: существования
данные: данные данных
вырасти: выросла
наименьший: наименьшей
представитель: представителей
частить: части
показательный: показательно
лошадь: лошади лошадей лошадях лошадям лошадьми
средство: средства средством
появление: появления появлением
связанный: связанная
получиться: получилось
дело: дела дело
датированных: датированных
ботайском: ботайском
сабатье: сабатье
колесами: колесами
мобильность: мобильность
выделяться: выделяются
экспансия: экспансию
затронуть: затронуло
пригодный: пригодные
одомашненных: одомашненных
откуда: откуда
претерпевать: претерпевают
пройти: прошло
составлять: составляла
смещение: смещение
предположение: предположением
лес: лесом
кинжал: кинжал
геном: геномов геномах геному геномами геномы геномам
передвижение: передвижения
колесо: колеса
нашить: нашей
старавшихся: старавшихся
достаточный: достаточно
испортиться: испортился
шаг: шага
отношение: отношения
снизиться: снизилась
наверняка: наверняка
минимум: минимум
радиоуглеродным: радиоуглеродным
внести: внести
ограниченный: ограниченный
животноводство: животноводства
обсуждаемой: обсуждаемой
пластеева: пластеева
логичный: логично
водиться: водились
размножение: размножением размножения
зубной: зубном
лошадиный: лошадиных лошадиного лошадиное лошадиная
приходиться: приходится
скаковой: скаковые
спрос: спрос
горлышко: горлышком горлышко горлышка
разнообразию: разнообразию
примерно: примерно
триумфального: триумфального
продляется: продляется
неоднозначный: неоднозначны
научиться: научились
телега: телеги
поле: поля
дания: дании
качественно: качественно
одомашнить: одомашнить
ботайцы: ботайцы
восточный: восточной
палеогенетических: палеогенетических
оси: оси
усредненный: усредненный
общий: общего
жертвенник: жертвенник
павла: павла
коневод: коневоды коневодов
низовье: низовьях
применимость: применимости
пришедшие: пришедшие
признать: признать
местный: местные местных местными
круг: кругов
керамика: керамики керамике
ловить: ловили
вплоть: вплоть
генофонда: генофонда
сюда: сюда
спортивный: спортивных
главный: главный
иметь: имеют имела имели
разобщены: разобщены
позволять: позволяет
использовать: использовали использовать
история: историю история
распространение: распространение распространения
костя: костей кости
распределение: распределению
компьютерный: компьютерных
типичный: типичное
происходить: происходят происходила
пар: пару
сайт: сайте
материал: материала материал
регион: регионах региона
будучи: будучи
жизнь: жизни
скипетр: скипетром
изощренные: изощренные
реконструировать: реконструировать
удалось: удалось
глубокий: глубокий
вид: виде
