данные: данные данных
отдел: отделы отделов отдел
бесчелюстными: бесчелюстными
животное: животных
гидроксилазы: гидроксилазы
сверху: сверху
предшественник: предшественники предшественниками
надпочечник: надпочечниками надпочечников
минина: минина
головной: головной
питаться: питаются
мозг: мозг мозга мозге
синить: синим
эволюционный: эволюционным эволюционном эволюционный эволюционного
промежуточный: промежуточное промежуточный промежуточном
особь: особей
елизавета: елизавета
гребень: гребня гребень
периферические: периферические
хромаффинные: хромаффинные
микроскоп: микроскопа
позвоночный: позвоночных позвоночными позвоночным позвоночного
крайний: крайней
хорды: хорды
простейший: простейшего
окрашивать: окрашивает
статья: статья статьи
катехоламинов: катехоламинов
таковой: таковых
консервативный: консервативны
белая: белым
зубец: зубцами
буравя: буравя
подтверждаться: подтверждалась
потенциальный: потенциально
организованный: организованных
меньшой: меньшим
видный: видна
дно: дно
вентральной: вентральной
происхождение: происхождения
симпатоандреналовую: симпатоандреналовую
медь: медь
синаптоандреналовую: синаптоандреналовую
габенулярные: габенулярные
например: например
средний: среднего средний
отделять: отделяет
присасываясь: присасываясь
мейнстрима: мейнстрима
модифицированного: модифицированного
орган: органа орган органами органов
план: плане плана
группа: группы группе
известный: известно известный
присутствовать: присутствуют
экспрессируется: экспрессируется
район: районе
установить: установить
строение: строения
удалось: удалось
результат: результатами результатам
разнообразный: разнообразных
миксин: миксин
окончательный: окончательно
задействованных: задействованных
новый: новой
примитивный: примитивными
краситель: краситель
опережать: опережают
доля: доли
именовать: именуют
полноценный: полноценного
катехоламины: катехоламины
воронко: воронка
адреналин: адреналина адреналин
образование: образование
заключение: заключение
автор: авторы авторов авторами
стадия: стадиях стадии
днк: днк
продукция: продукции
разделение: разделения
спинной: спинной спинного
занимать: занимают
мелкий: мелкие
основа: основу основе
провести: провели
надкласс: надкласс
мозжечок: мозжечок
активный: активно активны
ранний: раннем
вопрос: вопрос
формирование: формирования
работа: работе работы
хорда: хорда
предназначенный: предназначенный
образовать: образуют образует
недавний: недавняя
мишень: мишень
хордовые: хордовые
узел: узлы
последовательность: последовательность последовательностью
завершаться: завершается
подобный: подобно
который: которым которыми
показано: показано
находиться: находятся
принадлежность: принадлежности
используя: используя
идущие: идущие
сильный: сильный
передний: передний
личиночный: личиночных
выясниться: выяснилось
самый: самыми самые
встает: встает
показать: показала показали
биосинтез: биосинтеза
тироксингидроксилаза: тироксингидроксилаза
нотохорда: нотохорда
функционирующие: функционирующие
многие: многим
прежде: прежде
фарингеальной: фарингеальной
остается: остается
круглоротых: круглоротых
отличаться: отличаются
происходящая: происходящая
опора: опоры
белка: белки
симпатоандреналовых: симпатоандреналовых
одновременный: одновременно
расползаться: расползаются
считать: считать
давать: дают
хромафинные: хромафинные
поймать: поймать
язык: язык
череп: черепа
никто: никто
берет: берет
предшественница: предшественниц
бирюзовый: бирюзовым
сердце: сердца сердце
экспрессия: экспрессия экспрессией экспрессию
называемый: называемый
входить: входят
ответ: ответа
представленный: представлена представленная
состав: состав
отметить: отметить
экспрессируют: экспрессируют
найденных: найденных
крыша: крыше
энтеральные: энтеральные
факторов: факторов
симпатоандреналовая: симпатоандреналовая
одиночный: одиночных
тирозингидроксилазу: тирозингидроксилазу
воронка: воронкой
часть: часть
полностью: полностью
итак: итак
ход: ходе
ланцетника: ланцетника
флуоресцентной: флуоресцентной
собраны: собраны
предыдущий: предыдущих
дифференцировки: дифференцировки
окрашенных: окрашенных
кофакторы: кофакторы
ныне: ныне
преимущественный: преимущественно
исследователь: исследователям
подтвердить: подтвердили
современный: современного
париетальный: париетальный
челюсть: челюстей
цепочка: цепочек цепочки
иной: иной ином иного
симпатоандреналовые: симпатоандреналовые
трубка: трубкой
реакция: реакции реакция
сравнение: сравнению
прикрывающий: прикрывающий
лежащие: лежащие
стволовой: стволовых
важный: важно
вообще: вообще
экспрессирующих: экспрессирующих
вероятный: вероятно
тонкий: тонкие
хрящевого: хрящевого
начинать: начинает
аорта: аорты
найденные: найденные
минога: миноги миноге миног
рыба: рыбам
сложность: сложности
мочь: могли
дорсальной: дорсальной
считаться: считалось
доказать: доказать
обсуждаемой: обсуждаемой
кластер: кластеры
дальнейший: дальнейшие
поглощение: поглощения
нерв: нерв
используется: используется
обработка: обработка
фактора: фактора
дать: дал
убедиться: убедиться
исследование: исследований исследованиях исследования
лицевой: лицевой
наблюдать: наблюдали
происходить: происходят
скопление: скопление скопления скоплениями
модифицированную: модифицированную
возникать: возникают
формируют: формируют
описывать: описывал
эмбрион: эмбриона
напрашиваться: напрашивается
структура: структура структуры структурам
помеченная: помеченная
приобретение: приобретением
челюстноротых: челюстноротых
дофамин: дофамин
флуорофором: флуорофором
зона: зонах
тирозингидроксилазы: тирозингидроксилазы
являться: является являются
вид: вид виде
стресс: стресс
стимулировать: стимулирует
комплементарная: комплементарная
функционировать: функционировать
удаваться: удавалось
рисунок: рисунок
гидроксилаза: гидроксилаза
аналогичный: аналогичных аналогичны
связывающие: связывающие
редуцироваться: редуцируется
ромбовидный: ромбовидная
ганглий: ганглии ганглиев
необходимый: необходимых
природа: природу
сайт: сайта
точка: точка точки
снизу: снизу
некоторый: некоторому
гибкий: гибкий
качество: качестве
формируется: формируется
красный: красным
иннервируют: иннервируют
ранее: ранее
схема: схема
правый: правый
образ: образом
гистологический: гистологическим
зрение: зрения
проведенной: проведенной
противовес: противовес
личинка: личинка личинок
минимум: минимум
клетка: клетки клеток клетках клеткам
регуляторные: регуляторные
роговыми: роговыми
светиться: светиться
симпатоандреналового: симпатоандреналового
ученые: ученые
симпатоандреналовой: симпатоандреналовой
отверстие: отверстие
опубликованная: опубликованная
показатель: показатель
развиваться: развиваются
экспрессировались: экспрессировались
понимать: понимают
экспрессируются: экспрессируются
вблизи: вблизи
голова: головы
организм: организма
норадреналина: норадреналина
эксперимент: эксперименты
связаны: связаны
существовать: существуют существовать
зачаток: зачатки
начать: начало
трех: трех
отличающийся: отличающиеся
момент: момент
прилегающий: прилегающих
живущий: живущих
эмбриональный: эмбрионального
составляющая: составляющим
свечение: свечение
развитие: развития развитии
положение: положение
журнал: журнале
дофамина: дофамина
важнейший: важнейшую
следовать: следует
снабженная: снабженная
бесчелюстных: бесчелюстных
приводить: приводит
такой: таким
флуоресцентный: флуоресцентный
транспортер: транспортер
позволить: позволил
система: система системы системой
ланцетником: ланцетником
бей: бей
окрашенная: окрашенная
другой: другими
парасимпатическая: парасимпатическая
регулировать: регулирует
левый: левый
жаберный: жаберных
вышеупомянутый: вышеупомянутых
задний: заднем
железо: железо
опорный: опорную опорного опорной
хромаффинных: хромаффинных
указывать: указывали
синтезируется: синтезируется
управлять: управляют
поздний: поздних поздней
нейрогенез: нейрогенез
ткань: тканей ткани
ямка: ямка
многочисленный: многочисленными
принятый: принято
функционально: функционально
некоторые: некоторых
этап: этапах
бежать: беги
программа: программы
должный: должны
интересующего: интересующего
мягкий: мягких мягкие
слуховой: слуховой
подразделяться: подразделяется
тот: той
эволюция: эволюции
межпозвоночных: межпозвоночных
гибридизация: гибридизация
мезенхиме: мезенхиме
круглоротые: круглоротые
хорду: хорду
рнк: рнк
морской: морской
пусть: пусть
ген: гены гена ген
тяж: тяжи тяж
костный: костная
выявить: выявить
симпатобласты: симпатобласты
нервный: нервная нервного нервной нервный
возникнув: возникнув
экспрессирующие: экспрессирующие
выявление: выявление выявлением
разделенной: разделенной
ряд: ряда
появиться: появился
иметь: имеют
тип: тип типа
эпифиз: эпифиз
глазодвигательный: глазодвигательный
ведущая: ведущую
играть: играет
обонятельный: обонятельные обонятельный
бесчелюстные: бесчелюстные
отделиться: отделились
надежный: надежный
существенно: существенно
ключевой: ключевых
остальное: остальных остальными
роль: роль
серый: серо
обнаружены: обнаружены
подтверждать: подтверждает
миксины: миксины
тройничный: тройничный
направленный: направленные
пинеальный: пинеальный
зрительный: зрительный зрительные
название: названия
особый: особых
транскрипционных: транскрипционных
нейрон: нейроны нейронами
продольный: продольные
наличие: наличием
обнаружить: обнаружить
счет: счет
взрослый: взрослых
выделять: выделяют
норадреналин: норадреналин
высший: высших
частить: части
рот: рот
относить: относят
ученым: ученым
порождающие: порождающие
представитель: представители представителя
транскрипционные: транскрипционные
флуоресцентная: флуоресцентная
симпатический: симпатическая симпатической симпатическими
вегетативный: вегетативной
позвоночник: позвоночник позвоночника
метода: метод метода
индивидуальный: индивидуального
фото: фото
позвонок: позвонков
поодиночке: поодиночке
дополнительный: дополнительные
симпатоадреналового: симпатоадреналового
секвенирование: секвенирование
лицо: лица
сенсорный: сенсорные
расположенный: расположены расположенными
предполагаемый: предполагаемых
анализ: анализ
смочь: смогли
отличие: отличие
диск: дисков
оказаться: оказалось
секвенирования: секвенирования
заключить: заключили заключить
дуга: дуг
аналог: аналогов
рассеянный: рассеянные
синтезировать: синтезировать
функционирует: функционирует
источник: источник
признак: признак
скелетная: скелетная
специфический: специфические специфических
связь: связь
большинство: большинстве
глотка: глотки
транспортера: транспортера
ротовой: ротовая ротовой
относиться: относятся
участок: участку
детектируется: детектируется
иметься: имеются имеется
меря: мере
фермент: фермента ферменты
соответствующий: соответствующие
объединять: объединяют
тело: телу теле
разновидность: разновидность
помощь: помощью
располагаться: располагаются
зачаточный: зачаточный
обособленный: обособленные
располагающихся: располагающихся
вдоль: вдоль
обнаруживать: обнаруживали
раздельный: разделен
прочий: прочих
характеризоваться: характеризуются
периферическими: периферическими
количество: количеством
соединительный: соединительной
продолговатый: продолговатый
