другой: другими
испарение: испарение
рыба: рыба рыб
северный: северной
сказать: скажем
акула: акула
находиться: находятся
невелики: невелики
закрывающийся: закрывающийся
данные: данные
количество: количество
редкость: редкость
исчезнуть: исчезло исчезли исчезнуть
единый: единый
картинка: картинку
песок: песком
замкнутый: замкнутого замкнутый
новичок: новичками
жажда: жажду
отмеченными: отмеченными
динофлагеллят: динофлагеллят
мессинского: мессинского
вид: видами видов видах вида виды
ил: илом
морской: морской морские морских
например: например
прилегающий: прилегающих
изоляция: изоляция
атлантики: атлантики
выживание: выживания
событие: событий событие
разнообразия: разнообразия
полностью: полностью
местообитаний: местообитаний
стремительный: стремительно стремительное
множество: множество
вымереть: вымерла
видовой: видового видовое
предположить: предположить
встречаться: встречаются встречались
заметный: заметно заметные
повторно: повторно
тортонском: тортонском
покрытый: покрытая покрытое
мертвого: мертвого
фауна: фаун фаунами
разбитый: разбит
средиземноморье: средиземноморье
называемому: называемому
постепенный: постепенное
приток: приток притока
крупный: крупных
превратиться: превратились превратиться
влияние: влияние
жаркий: жаркого
сокращение: сокращению
затруднять: затрудняет
фораминифер: фораминифер
пролив: пролив пролива проливу
отложение: отложения отложений отложениях
западный: западная западного западном западное
ситуация: ситуация
международный: международная
ученые: ученые
молодой: молодых
расхождение: расхождению расхождение
условие: условия
предстоять: предстоит
биоты: биоты
утолить: утолить
обратный: обратная
произойти: произошла
уйти: ушло
век: века векам веке
занклскому: занклскому
выживший: выжившие
вымирание: вымирания вымиранию
одновременный: одновременно
интенсивный: интенсивное интенсивный
пережить: пережил
пересоленной: пересоленной
палеонтологический: палеонтологической
итог: итоге
кролик: кролик
причина: причине
белая: белая
часть: часть
меря: мере
изолированный: изолированных
снизиться: снизилось
слово: словами
видообразование: видообразования
гиперсоленых: гиперсоленых
окончательный: окончательно
отделиться: отделилась
средиземном: средиземном
благоприятный: благоприятными
уменьшение: уменьшения уменьшение
прозвать: прозвали
учтены: учтены
заполнение: заполнения
приходиться: приходится
коралловый: коралловых
ныне: ныне
ранний: ранняя ранней ранние
море: море моря морем
кризис: кризис кризисом кризисы
учитывая: учитывая
разнообразие: разнообразие
мезо: мезо
практически: практически
дельфин: дельфины
потеря: потери
ограничение: ограничений ограничениям
найденных: найденных
пустошь: пустошь
потребоваться: потребовались
сухой: сухого
водоемах: водоемах
предел: предел
толщь: толщи
оставивший: оставивший
животное: животным животные животных
оценивалось: оценивалось
биоте: биоте
риф: рифов
осушение: осушения осушение
водоемов: водоемов
африка: африкой
занклская: занклская
частить: части
эндемиков: эндемиков
новый: новой новые
территория: территории
помимо: помимо
привести: привело привели
бета: бета
гиперсоленые: гиперсоленые
сравнительный: сравнительно
начаться: началось начался
добраться: добраться
опустевший: опустевший
уцелеть: уцелели
возрасти: возросло
мировой: мирового
огромный: огромные
водоемы: водоемы
карликовость: карликовость
оказаться: оказалось оказался оказались
обернуться: обернулось
трех: трех
страна: стран
двустворчатый: двустворчатых
состав: составе
мочь: могла могли
сброшено: сброшено
появиться: появился появились
заселявших: заселявших
озер: озер
средиземным: средиземным
гибралтарский: гибралтарский
соответствующий: соответствующие
дальнейший: дальнейшем
приводящие: приводящие
размер: размеры
испариться: испарилось
остракод: остракод
наполниться: наполнилось
общий: общее
местный: местных местной
водный: водной
средиземное: средиземное
средиземного: средиземного
юго: юго
европейский: европейских
середина: середины
двух: двумя
численность: численности
шанс: шансы
новиковская: новиковская
соленая: соленая
нескольких: нескольких
островная: островная
тортонской: тортонской
организм: организмов
известный: известно
изучено: изучено
результат: результате результатом результаты
выживать: выживать
десятилетие: десятилетия
материк: материком
образец: образцов
млн: млн
биоразнообразии: биоразнообразии
значительный: значительная
столкновения: столкновения
сценарий: сценарий
жизнь: жизни
разобраться: разобраться
соляный: соляным соляных соляные
возможный: возможно возможных
лишиться: лишилось
источник: источника источник
восстановление: восстановление
появляться: появляются
исчезновение: исчезновение исчезновению
океан: океана
момент: момент
средиземноморья: средиземноморья
сухопутный: сухопутные сухопутным сухопутных
открытие: открытием
богатый: богаче
целый: целом
автор: авторы
предложить: предложили
бассейн: бассейны бассейн бассейна
громадный: громадное громадные
евразийский: евразийской
темп: темпам
неполнота: неполнота
последовавшие: последовавшие
случаться: случались
высыхание: высыхания
регион: регионы регионов
исторический: историческое
свидетельство: свидетельств
дезоксигенация: дезоксигенация
адриатики: адриатики
зарегистрированный: зарегистрированных
стратификация: стратификация
земной: земной
продолжать: продолжали
замена: замены замена
пересмотрены: пересмотрены
снижение: снижению снижение
плохой: плохо
исследование: исследования исследований
образ: образом
пример: примеров
толщина: толщина
планктон: планктона
любой: любой
появление: появлению появление
частичный: частичная
островных: островных
обитать: обитал
использование: использованием
нынешний: нынешнее нынешний нынешними
биоразнообразие: биоразнообразие
мелкий: мелких мелкие
эндемика: эндемика
называемый: называемый
подсчетов: подсчетов
потоп: потопу
являться: является
африканский: африканской
существующий: существующих
наблюдаемому: наблюдаемому
оценка: оценку
гигантский: гигантское гигантский
атлантический: атлантических
кой: кое
толстый: толстым
карта: карта
фото: фото
миграция: миграции
самый: самые самых
сёренсена: сёренсена
тортонскому: тортонскому
массовый: массовое
достигать: достигает
мессинским: мессинским
богатство: богатства
иной: иными
суббассейнов: суббассейнов
понять: понять
пресный: пресной
мост: мосты
случившееся: случившееся
сбор: сбора
донный: донных
вновь: вновь
процесс: процессов
плиоцен: плиоцена
тысячелетие: тысячелетие тысячелетия
колебание: колебания
полный: полного полному
перекрытие: перекрытия
высокий: высоким выше
научный: научных
водоем: водоем
обширный: обширном
провести: провела
сотня: сотни
больший: большую большей большая
процент: процент
земля: земле
впадать: впадать
простой: проще
коэффициент: коэффициента
прошлое: прошлого
слон: слон
найтись: нашлась
следующий: следующий
эндемиками: эндемиками
мелководный: мелководных
соленых: соленых
группа: группа
формирование: формированию
гибралтарского: гибралтарского
стать: стало стали
основа: основе
летопись: летописи
озеро: озера
свыше: свыше
ученых: ученых
знать: знали
биоразнообразия: биоразнообразия
выглядеть: выглядело
биотами: биотами
несмотря: несмотря
масштабность: масштабность
связано: связано
сайт: сайта
солености: солености
количественный: количественную
подтверждающих: подтверждающих
полутора: полутора
различие: различие различий
гибралтарскому: гибралтарскому
статья: статьи
закрыться: закрылся
день: дня
органический: органический
примерно: примерно
воздействие: воздействием
эпоха: эпохи
достигнуть: достигло
знаковый: знаковые
место: местами месте
оставаться: оставалось
эндемичных: эндемичных
проявляться: проявляться
ярус: ярусу ярусе яруса
сложиться: сложилась
обычный: обычных
стеногалинных: стеногалинных
градиент: градиент
рисунок: рисунок
конечный: конечном
выбрав: выбрав
река: реки
европа: европой
вода: воды водой водах
неоднократный: неоднократно
показывать: показывают
мир: мир
исчезнувших: исчезнувших
позволить: позволило позволили
слой: слоем
лебедь: лебедь
уровень: уровня
отдельный: отдельных
назвать: назвали
плита: плит
остров: островов островами островах
эндемичности: эндемичности
такой: таких
северо: северо
низменность: низменности низменность
сицилия: сицилии
анна: анна
компиляция: компиляции
высохнуть: высохли высохло
тектонический: тектонических
дно: дне дно
карликовый: карликовый
непригодный: непригодным
наполняться: наполняться
гигант: гигантом гиганта
мессинскому: мессинскому
протерозою: протерозою
повлечь: повлекло
установиться: установился
возможность: возможностью
моллюск: моллюсков моллюск
основный: основного
испаряться: испаряться
который: которое
километр: километров
работа: работы
уникальный: уникальных
видимый: видимому
благополучный: благополучно
изменение: изменений изменения
нуралагус: нуралагус
безвозвратный: безвозвратные
какой: каким
циркуляция: циркуляции
восток: восток
менорке: менорке
тортонская: тортонская
образовавшиеся: образовавшиеся
объяснять: объясняет
костистый: костистых
млекопитающий: млекопитающих
брюхоногие: брюхоногих
выпадение: выпадение
глубина: глубиной
гигантизм: гигантизм
течение: течение
относиться: относятся
мертвое: мертвое
заселить: заселить
точка: точками
предшествующий: предшествующие
определенный: определенный
восточный: восточной восточного восточном
островной: островной
занклского: занклского
установление: установление
популяция: популяций
раскинуться: раскинулась
исследователь: исследователей
одних: одних
брюхоногий: брюхоногий
заменённый: заменена
начать: начало
упасть: упал
катастрофа: катастрофой
предположительно: предположительно
космополитных: космополитных
нектона: нектона
миллион: миллиона
минимум: минимум
поэтому: поэтому
занклском: занклском
мессинская: мессинская
различаться: различались
способствовать: способствовало способствует
миоцен: миоцена
произошедшее: произошедшее
компенсировать: компенсировать
конец: конце
запад: запада
многие: многим многих
батипелагических: батипелагических
средиземноморский: средиземноморской средиземноморским средиземноморских средиземноморский средиземноморская
повторный: повторного
климат: климата
тортонского: тортонского
сожаление: сожалению
ученым: ученым
соль: соли
трем: трем
обсуждаемой: обсуждаемой
история: истории
напиться: напиться
евразия: евразией
возникнуть: возникли
придонных: придонных
мессинский: мессинский
ископаемое: ископаемого
объемов: объемов
мессинской: мессинской
залежь: залежи
соленые: соленые
происходить: происходило происходила
