мелкозернистый: мелкозернистый
фиксировать: фиксировал
целый: целом
частить: части
условие: условиях условия условий условиям
порода: породах пород
вещество: веществе
переработать: переработали
формируется: формируется
результат: результате результаты результатам
непрерывный: непрерывного
водяного: водяного
осадочный: осадочные
установить: установили
лазерный: лазерный
процентный: процентным
жидкий: жидкой
сохраняться: сохраняются
статья: статьи
отличаться: отличается
стабильный: стабильный стабильным стабильные
исследовать: исследовал
аморфный: аморфной аморфная аморфный
разнесен: разнесен
разный: разными разным
суточный: суточных
переход: переход
высыхание: высыхания высыханием
нанофаза: нанофаза
водород: водорода водород
похожий: похожа
озеро: озера
полученное: полученное
холодный: холодной холодными
соответствие: соответствие
составлять: составляет
рентгеноструктурный: рентгеноструктурный
образ: образом
такой: таких
честь: честь
квадрупольный: квадрупольный
великобритания: великобритании
окисление: окисления
твердых: твердых
выполнять: выполняет
причем: причем
дюйм: дюйм
измерение: измерения
устойчивый: устойчиво
ассоциация: ассоциацию
высвобождаться: высвобождаться
выпадать: выпадает
группа: группа группой
неопределенной: неопределенной
прибор: прибор
растапливать: растапливали
процент: процент
парциальном: парциальном
осаждение: осаждение
данный: данном
минеральный: минеральном минеральных минеральной
журнал: журнале
различный: различных
конец: конце
исключительный: исключительной
война: войны
португалия: португалия
волна: волны
значительный: значительно значительной
компонент: компонентом компоненты
частица: частиц частицами частицы
путь: пути путь
формирование: формирование
экспресс: экспресс
сигнал: сигнал
часы: часов
газ: газы газах
новый: нового
дос: дос
кристаллит: кристаллиты
примечательный: примечательно
нанофазы: нанофазы
эмиссионной: эмиссионной
агрегация: агрегация
кровь: кровь
продукт: продуктом продукты
называемая: называемая
сталактит: сталактиты
содержащий: содержащих
нерастворимый: нерастворимое
происхождение: происхождения происхождение
мочь: могли могло
пещера: пещеры
сравнение: сравнение
зеленый: зеленый
буря: бурь
стабильность: стабильности
ученых: ученых
атмосфера: атмосферу атмосфере атмосферы атмосфера
способность: способности
тонкий: тонкую
планета: планетой планет планету планеты планета планете
дешер: дешер
облучение: облучение
встреча: встрече
фото: фото
реголите: реголите
неясный: неясной
тесный: тесную
называть: называют называли
показывать: показывали показывает
плохой: плохо
проведенного: проведенного
теплой: теплой
изображение: изображение
десятилетие: десятилетий
кора: коры
зависеть: зависит
оксид: оксидов оксида оксидами
красный: красной красная красный
интегральный: интегральной
коррелировало: коррелировало
крупный: крупные
рис: рис
предположить: предположили
пар: пара
европейский: европейского
разделяющий: разделяющий
соединение: соединения
настраиваемый: настраиваемый
кристаллизованный: кристаллизованный
линия: линий
феррогидрита: феррогидрита
автор: авторы авторами авторов
программа: программы
атмосферный: атмосферной
сера: серы
базальтовый: базальтовой базальтового базальтовых базальтовые
сравнить: сравнили
требовать: требует
амаль: амаль
пыль: пыли пыль
ранний: раннего
достаточный: достаточно
термодинамический: термодинамической
измельченного: измельченного
акагенеит: акагенеит
потеря: потере
абсорбционный: абсорбционный
пережить: пережила
железо: железа железом железо
спектральный: спектральные спектральная спектральных спектральным
поздний: поздние позднее
параметр: параметрам
дневный: дневный
рентгеновский: рентгеновские
взаимодействие: взаимодействие взаимодействию
исследование: исследовании исследования
история: истории
ферригидрита: ферригидрита
активность: активности
полученной: полученной
низкий: низком низкими низкие
экспериментальный: экспериментальном
тип: типами типа
совпадать: совпадают совпадает
агрегат: агрегаты
трехвалентное: трехвалентное
благодаря: благодаря
фракция: фракции
дополнительный: дополнительную
изменить: изменил
переноситься: переносились
миссия: миссиями миссии миссий
лазерно: лазерно
время: временем
главное: главным
режим: режим
бог: бога
напоминать: напоминает
присутствующий: присутствующей
превращение: превращение превращения
эпоха: эпоху
преобразование: преобразование преобразовании преобразования
править: правило
смешав: смешав
поверхность: поверхности
осаждении: осаждении
многочисленный: многочисленными
размер: размером размер размеру
кислый: кислым
удаление: удаление
образовать: образует
международный: международная международной
придающим: придающим
приборного: приборного
приближены: приближены
смесь: смесями смеси смесь смесей
выветривание: выветривании выветривания выветриванию
помощь: помощью
температура: температур температурами температуры температура температурой
моделируемых: моделируемых
усиливая: усиливая
маггемит: маггемит
кристаллизация: кристаллизации
характеристика: характеристики
спектрометрия: спектрометрии
наса: наса
спектрометр: спектрометра спектрометром спектрометр
накопиться: накопиться
отложение: отложения
земля: земле
полноцветное: полноцветное
автоматический: автоматической
течение: течение
образовавшийся: образовавшийся
фаза: фаза фазы фазой фаз фазу
марсохода: марсохода
имитационной: имитационной
спирит: спирит
современный: современных современные
гидроксида: гидроксида
переносить: переносили
стрекопытов: стрекопытов
почва: почве
особенность: особенности
азорские: азорские
соотношение: соотношений
кристаллический: кристаллические кристаллических
первичный: первичным
формирует: формирует
миро: миром
борт: борту
лабораторный: лабораторных лабораторный лабораторной
дать: дали
терять: теряет
делать: делают
максимальный: максимально
бассейн: бассейны
наблюдение: наблюдениям наблюдений наблюдения наблюдениями
реголита: реголита
углерод: углерода
сохраняя: сохраняя
эоловые: эоловые
установленный: установленной установленного установленным
соответствовать: соответствует
значение: значения
поверхностный: поверхностные
содержание: содержание содержанием
состоять: состоит
дегидратируется: дегидратируется
гётит: гётит
важный: важным
август: августа
концентрация: концентрация
имитирующий: имитирующий
сложный: сложные
выделяемых: выделяемых
осаждается: осаждается
зависимость: зависимости
лепидокрокит: лепидокрокит
система: системы
мелкий: мелкой мелкие
марсоходом: марсоходом
замедлять: замедляют
обстановка: обстановках обстановке
существовать: существует существовал
постепенный: постепенно
степень: степени
составленной: составленной
обогащенные: обогащенные
доминирующий: доминирующей
высокий: высоких высокая выше
млрд: млрд
дет: дет
произошел: произошел
гидратированная: гидратированная
минералогический: минералогические минералогический минералогическая
кислород: кислорода кислородом
аль: аль
повсеместный: повсеместно
термодинамически: термодинамически
адсорбированной: адсорбированной
хлора: хлора
треть: трети
давление: давлении давление
структура: структуру
эрозия: эрозией
охристый: охристый
охватывающего: охватывающего
отражательный: отражательной
использовать: использовали
придает: придает
влажный: влажным
мнение: мнению
окислительный: окислительных окислительного
солнечный: солнечной
осаждения: осаждения
имитационных: имитационных
сиреневый: сиреневый
примерно: примерно
нанокристаллитов: нанокристаллитов
гётита: гётита
миллиард: миллиардов
гидратированный: гидратированный
газовый: газовый газовые
полоса: полосы
нескольких: нескольких
указывать: указывало указывают указывает
рентгенофлуоресцентного: рентгенофлуоресцентного
выделяемые: выделяемые
образец: образцов образец образца
либо: либо
связанный: связан связанные
образующаяся: образующаяся
показать: показали показал
агентство: агентства
сточный: сточные
часть: часть
лаборатория: лаборатории
микрометр: микрометра
образоваться: образовалась образуется
проводивший: проводивший
среда: среде средой
швертманнит: швертманнит
чистый: чистого
зона: зонах
засушливый: засушливыми засушливым
первоначальный: первоначально
выявить: выявили
оливин: оливином
гесперийского: гесперийского
черный: черный
нахождение: нахождения
истиранию: истиранию
окисел: окислы
химический: химического химический химическому
остров: остров острова
образуя: образуя
придавая: придавая
межпланетный: межпланетной
обсуждаемой: обсуждаемой
основа: основе
помимо: помимо
оказаться: оказалось
мёссбауровским: мёссбауровским
точный: точные
место: место
позднегесперийское: позднегесперийское
марсоходах: марсоходах
миллиметровый: миллиметровых
проанализировать: проанализировали
сша: сша
ферригидрите: ферригидрите
анализ: анализа анализ
длительный: длительного
информация: информацию
обнаружить: обнаружил
акаганеитом: акаганеитом
интенсивный: интенсивной
мир: мир
египтянин: египтяне
подниматься: поднимается
комплекс: комплекса комплекс
мкм: мкм
происходить: происходила происходило
посредство: посредством
водный: водных водной водного
опубликованного: опубликованного
реконструктивный: реконструктивное
представление: представлении
многие: многих
кристаллизоваться: кристаллизуется кристаллизовался
путем: путем
переходить: переходит
считать: считали считают
последний: последних последние
собранный: собранные
оставаться: оставалась
твердофазное: твердофазное
гётитом: гётитом
диодно: диодно
грута: грута
магнетит: магнетит
встречаться: встречалась
вывод: вывод
число: числе
ученые: ученые
сферул: сферул
изменение: изменения
состав: составе состав составу
потолок: потолка
ферригидрит: ферригидрит
гематита: гематита
хер: хер
определить: определить
эоловой: эоловой
придавать: придают
пылевых: пылевых
разрушаться: разрушались
приводить: приводит
получившей: получившей
аналитический: аналитического аналитический
поперечник: поперечнике
демонстрировать: демонстрировал
отобранные: отобранные
способствовать: способствуют
раствор: растворов растворах раствора
гидроксидами: гидроксидами
известный: известный
подвергаться: подвергались
эрозионные: эрозионные
модель: модели
амазонийского: амазонийского
химически: химически
характерный: характерный
попытаться: попытались
теплых: теплых
метаболической: метаболической
отличие: отличие
метастабильный: метастабильный
создать: создала создали
красноватый: красноватый красноватое красновато
массы: масс
изначальный: изначально
означать: означает
характеризоваться: характеризуются
картина: картины
зерен: зерен
природа: природа
лавовый: лавовой лавовые
швертманнитом: швертманнитом
источник: источником источник
таяние: таяние
бурый: бурого
развитие: развития
цвет: цветом цвет цвета
колебание: колебаний
молекулярный: молекулярные
обогащенную: обогащенную
имитированных: имитированных
косвенный: косвенным
оаэ: оаэ
сухой: сухой сухом сухого
предыдущий: предыдущими
имевшей: имевшей
швейцария: швейцарии
стадия: стадиях
обогащённый: обогащена
согласоваться: согласуется
марсианский: марсианской марсианского марсианском марсианскую марсианских марсианские марсианским
спектр: спектр спектру спектра спектры
растворение: растворение
образование: образованием образования
вулканический: вулканический вулканических вулканической
летучий: летучие
воздействие: воздействие
являться: является являлись являются
представленный: представлено
ответить: ответить
нуль: нуля
минерал: минералом минералы минералов минерал
выполненным: выполненным
быстрый: быстрого быстрым
вулкан: вулканы
включающий: включающий
гематитом: гематитом
проведенный: проведенный
смести: смести
фероксигит: фероксигит
безводный: безводные
случайный: случайно
выполненной: выполненной
предполагать: предполагает
изотоп: изотопов
рисунок: рисунок
кривой: кривая кривой
тонкопорошковых: тонкопорошковых
преобладание: преобладанием
гематит: гематит
неизмененных: неизмененных
сменяться: сменялись
распространиться: распространились
форма: форме формы
кислотность: кислотность
ледник: ледников ледники
грунт: грунта грунте
материал: материала материал
нагревание: нагревании
набор: набора
последующий: последующим
владислав: владислав
терсейра: терсейра
эксперимент: эксперименты эксперимент
лёд: льдом
определение: определения
смектиты: смектиты
весь: всей
протяжение: протяжении
присутствие: присутствии присутствием присутствие
период: периода периоды периодами
богатый: богатых богатая
марс: марса марс марсу марсе
входящий: входящего
создавать: создавало
оттенок: оттенок
производная: производными
благоприятный: благоприятные
практически: практически
вопрос: вопрос
который: которое
включать: включает
доказывать: доказывают
анализирующий: анализирующий
ассоциировать: ассоциировала
земной: земных
тонкопорошковая: тонкопорошковая
синий: синий
например: например
размыв: размыва
базальт: базальт базальтах базальтов базальта базальты
свечение: свечение
искровой: искровой
станция: станции
бактерия: бактерий
физический: физического физическом
многодиапазонной: многодиапазонной
название: название
хроматограф: хроматограф
видимый: видимой
дегидратации: дегидратации
исследователь: исследователей исследователи
гидратированных: гидратированных
данные: данные данными данным
франция: франции
желтый: желтый
действовать: действовали
этап: этапа
заметный: заметно
балкойнс: балкойнс
имитация: имитацию
другой: другими
пола: полу
скрытокристаллическую: скрытокристаллическую
просачиваться: просачивается
трансформируется: трансформируется
лава: лавы
космический: космического
кьюриосити: кьюриосити
рентгеноструктурного: рентгеноструктурного
длина: длины
процесс: процесс процессы процессе
дифракционные: дифракционные
гидратации: гидратации
ферригидритом: ферригидритом
римлянин: римляне
канада: канады
идеальный: идеально
ветровой: ветровой
камера: камерой
реальный: реального
оппортьюнити: оппортьюнити
входить: входил
вода: воды вода водой
основный: основным основную основных
условный: условное
