занимающихся: занимающихся
уточняющих: уточняющих
анатомически: анатомически
след: следу следов
физиологически: физиологически
грунт: грунте
предполагать: предполагали
день: дни днями
называться: называется
избавиться: избавиться
прийтись: пришлось
брать: брали
последующий: последующую
канака: канака
некоторый: некотором
приводить: приводят
название: названия
реальность: реальности
доступность: доступность
анализ: анализ
определенных: определенных
быстрый: быстрее быстры
встречать: встречает
скорый: скорее
бегунья: бегуньи
преследовать: преследовал преследует преследуют
последний: последние
запряженных: запряженных
отчаявшись: отчаявшись
разгоняться: разгоняется
период: период
истощенное: истощенное
лучший: лучшие
затратнее: затратнее
устойчивый: устойчивое
канна: канны
обыкновение: обыкновение
охота: охоту охоте охоты охота охот
канада: канады
затрата: затраты затратам затрат
убить: убить убил
куду: куду
сша: сша
передвигаться: передвигается
необычайный: необычайную
удачный: удачное удачной удачных
крупный: крупная
добывать: добывает
позволить: позволил
сделав: сделав
бравый: бравых
вел: вел
полагать: полагали
лось: лося лоси лось лосем
ускользнуть: ускользнуть
домыть: домой
выбиться: выбьются
пропитание: пропитания
спугивают: спугивают
использовалась: использовалась
спринтерские: спринтерские
единичный: единичными
слабый: слабо слабой слабыми слабое
становиться: становится становятся
целить: цели
загнавший: загнавший
обязательный: обязательно
эволюция: эволюции эволюцию
погоня: погоня погони погоню
сократить: сократить
выжить: выжить
позавидовать: позавидовало
шерсть: шерсти
аборигенных: аборигенных
исследователь: исследователей
равный: равно
темп: темп
содержащий: содержащих
затратности: затратности
стать: стать стала стало
александр: александр
конкистадоров: конкистадоров
утро: утром
вспомнить: вспомнить
очевидный: очевидно
газель: газель
исследование: исследование исследования
объект: объектами
собраться: собраться
анатомический: анатомические
автор: авторы авторам
провести: провели
огнестрельный: огнестрельного
коллега: коллегами
смысл: смысл
свой: своими свой своему
отличие: отличие
поступать: поступает поступают
непомерный: непомерных
сутки: сутками
хищник: хищниками
нарта: нартах
изучение: изучению
транспортировка: транспортировку
африканский: африканской африканские
стоянка: стоянки
прошлое: прошлом
исчезнувшая: исчезнувшая
развиться: развились
избыточный: избыточного
собранный: собранные собранных
вывод: выводов
часы: часами часов
новый: новый
лихва: лихвой
вовсе: вовсе
география: география
срезая: срезая
полученные: полученные
сравнение: сравнению сравнения
выбор: выбор
америка: америки
отказ: отказа
желез: желез
зрение: зрения
поскольку: поскольку
этнографов: этнографов
эккринных: эккринных
потение: потение
северный: северной северные
лук: луком
освежевывает: освежевывает
поймать: поймал
зима: зимой
цивилизация: цивилизацией
континент: континентах
результат: результаты
ночует: ночует
сообщаться: сообщается
дистанция: дистанции
подробный: подробно подробные
прямой: прямо
резник: резник
лёгкий: легко легче
радикальный: радикально
быстроногий: быстроногую
пояс: пояса
средство: средств средствами
снег: снегу снег
второй: вторых вторая
дикий: диких
разгар: разгар
журнал: журнале
разный: разных разной
диапазон: диапазоне
спастись: спастись
распространенность: распространенность
попытка: попытках
ночь: ночи
беременный: беременное
озеро: озера
называемую: называемую
история: историю
выносливый: выносливые
тепло: тепла
данный: данной данного
список: список
считая: считая
мнение: мнение
повышенный: повышенная повышен
вплоть: вплоть
саванна: саванне
уточнить: уточнили
рекордный: рекордное
умеющим: умеющим
находить: находят
остается: остается
дышать: дышать
появление: появление
давний: давних давние
эжен: эжен
подошел: подошел
садиться: садился
обилие: обилие
скорость: скоростью скорости скорость
выраженной: выраженной
преследуемая: преследуемая
охлаждение: охлаждения охлаждением
число: число числе
упрощать: упрощает
жилище: жилищу
имеющийся: имеющееся имеющиеся
изучен: изучен
гепард: гепард гепарды
голодный: голодные
лошадь: лошадей лошади
транспортный: транспортных
атлет: атлеты
материал: материалах
дичь: дичь
нож: нож
преследователь: преследователя
трудоемкой: трудоемкой
пустынь: пустыни
аттенборо: аттенборо
итог: итоге
включая: включая
рост: рост
пример: примеров
беотуки: беотуки
медведь: медведи
важный: важную важной важных
эрика: эрика
жесткой: жесткой
поэтому: поэтому
усталость: усталости
упрощенными: упрощенными
знаменитый: знаменитого
неэффективность: неэффективность
благодаря: благодаря
отклонение: отклонении
видимый: видимому
жертва: жертва жертву жертвой
группа: группы
подтверждающие: подтверждающие
кучины: кучины
перерыв: перерыва
настигать: настигают настигает
оптимума: оптимума
солнце: солнцем
брюс: брюс
сразу: сразу
технический: техническими
статья: статье статьи
выкладывание: выкладывания
толстый: толстый
бизон: бизоны
снижение: снижение
ньюфаундленд: ньюфаундленд
годах: годах
изображение: изображение
частность: частности
убежище: убежище
стенбоки: стенбоки
сыграть: сыграла
наблюдать: наблюдал
выдохнуться: выдохся
упадет: упадет
культура: культур культуре
годы: годы
задний: задние
тропический: тропические
высокий: выше
язык: языках
казаться: кажутся
антилопа: антилопу
волокно: волокон
адаптированы: адаптированы
связь: связи
размер: размер
параметр: параметров
волк: волки
любой: любом любых
заканчиваться: заканчивается
близкий: ближе
тысячелетие: тысячелетиями
животное: животные животных животное животного
нуэр: нуэр
специальный: специального специально
подогнать: подогнать
вооруженными: вооруженными
подобный: подобные
математический: математическом
начинать: начинает начинал
полдень: полдня
размокнуть: размокнет
противник: противники
сцеплены: сцеплены
шаг: шаге шагом шага
активный: активно
секунда: секунд
бушмены: бушмены
восстанавливать: восстанавливал
опережать: опережает
зародившись: зародившись
переход: переходе
отставшего: отставшего
неохотно: неохотно
дэвидом: дэвидом
обоснована: обоснована
используя: используя
скакать: скачут
снегоступы: снегоступах снегоступов
эттенборо: эттенборо
век: века
течение: течение
такой: таких такого таким такую
показать: показал
вдох: вдох
найти: найти
использовался: использовался
продолжительность: продолжительность
пытаться: пытаться пытайся пытались
описание: описание описаний
ожиревшее: ожиревшее
убитый: убитую
окупаться: окупается
способность: способности
оказаться: оказалось
усилие: усилий
выносливость: выносливостью выносливости выносливость
потеть: потеть
говорить: говорили
помалу: помалу
европа: европе
труд: трудом
снижаться: снижается
коза: коз
едва: едва
выясняться: выясняется
согласоваться: согласуются
лыжи: лыж
обычный: обычной обычное обычным
измученный: измученное измученного
антропогенезе: антропогенезе
экзотика: экзотика экзотикой
дает: дает
поведение: поведении
неоправданный: неоправданной
мышечный: мышечных
позади: позади
возвращаясь: возвращаясь
сезон: сезона сезоны
плейстоценовой: плейстоценовой
огромный: огромные
миро: миру
который: которым которому котором которое
длительный: длительному длительных длительного
тазовый: тазового
освоить: освоить
используется: используется
чередовать: чередует чередовать
выдвигаться: выдвигались
распространение: распространение
пешком: пешком
уставшие: уставшие
идти: идти
рассказать: рассказал
ритм: ритм ритмом
жестко: жестко
бояться: боятся
местный: местный
получше: получше
французский: французском
климат: климатом
большинство: большинство большинства большинстве
отдельный: отдельно
основа: основе
оппонент: оппоненты
сообщество: сообществами
бегать: бегал
изученности: изученности
распространенной: распространенной
беспрестанный: беспрестанно
пытаясь: пытаясь
тунгусский: тунгусский
добытым: добытым
дом: дома
этнографическая: этнографическая
молодежь: молодежь
думать: думать думали
обусловленный: обусловлен
современность: современности
копытный: копытные
кароха: кароха
черта: черты
пересчет: пересчет
подпускать: подпускает
крайний: крайне крайней
редкость: редкость
ослаблены: ослаблены
больной: больное
уникальный: уникальные уникален
решение: решение
сведение: сведения
лудить: лужу
побеждать: побеждает
особенность: особенности
добыча: добычу добычи добыча добыче
ограничение: ограничения
средний: средняя
народ: народа
причем: причем
приведенные: приведенные
больший: большая большей большее
доля: доля доли
пронзены: пронзены
численность: численности
пользоваться: пользовался пользовались
стайерские: стайерские
аргумент: аргументы аргументом
бедный: бедный
остальное: остальным
многократный: многократно
марков: марков
первый: первой первых первого
аллюр: аллюром
дотащить: дотащить
олень: оленя олень олени
принцип: принципе
оцифровки: оцифровки
невыгодный: невыгодна
научный: научной
азия: азии
зебра: зебры
удается: удается
упоминание: упоминаний упоминания
загонять: загоняют загонять
копьё: копьями
европейский: европейских
остановка: остановками остановок
неполный: неполны
интернет: интернете
превышать: превышает
раз: разом
южный: южный южной
подходящий: подходящей
открытый: открытых
короткий: короткие
предок: предкам предки
американец: американцев
относительный: относительно
свести: свести
оптимальный: оптимальный оптимальной
молодой: молодые молодое
темнота: темноты
мышца: мышцах
опровергнуты: опровергнуты
практикуемуе: практикуемуе
описываемые: описываемые
другой: другими другому
типичный: типичными
обычай: обычаи обычаев
перегрев: перегрева
практиковать: практиковали
индеец: индеец индейцев индейцы
голод: голодом
приемов: приемов
этнографических: этнографических
калорийность: калорийность
процесс: процесс
дождевой: дождевые
поддерживаться: поддерживаться
твердом: твердом
неподалеку: неподалеку
давать: давал
пространство: пространствах
ходьба: ходьбе ходьбы ходьбу
калория: калорий
состоять: состояло
пар: пару
расстояние: расстояние расстоянии
дискуссия: дискуссии
среди: среди
энергетический: энергетическую энергетического энергетические энергетически энергетическим энергетических энергетической
оптимум: оптимум
полевой: полевых
широкий: широко широком шире
осторожный: осторожно
наст: настом
место: места месту
глаз: глазами
преследование: преследование
вскоре: вскоре
лес: лесу леса
аккуратный: аккуратный
времен: времен
выгоднее: выгоднее
сообщение: сообщений
среда: среде
горожанин: горожанина
достигать: достигает
следовать: следует
кошачьи: кошачьи
неторопливый: неторопливо неторопливый
приходиться: приходится приходилось
загоняя: загоняя
изнеженный: изнеженным
невозможный: невозможно
круглый: круглый
род: родов
пробежать: пробежал
приблизить: приблизить
туземец: туземцы туземцев
состязание: состязания
упорный: упорно упорная
записка: записках
останавливаться: останавливается останавливаются
тринкауса: тринкауса
испанский: испанском испанских
одиночка: одиночку
собственный: собственный собственное
зверь: зверей зверь
ложиться: ложится
недавний: недавнего
закрепленные: закрепленные
ритуализованные: ритуализованные
рис: рис
требовавшие: требовавшие
африка: африке
ссылаться: ссылались
ждать: ждут ждали
найденных: найденных
растерянный: растерянными
метода: метод
верхний: верхнего
хайнрих: хайнрих
фото: фото
нагрузка: нагрузках
ездить: ездят
пробежав: пробежав
практика: практикой
жирафа: жирафа жирафами жирафы
серьезным: серьезным
страна: странах
специализированных: специализированных
продолжаться: продолжается
взгляд: взгляд
пот: пота
накладывать: накладывает
спроектированы: спроектированы
отдохнуть: отдохнуть
степень: степенью
рассказывать: рассказывают
гавайцы: гавайцы
преследуемого: преследуемого
ориксы: ориксы
сайт: сайта
район: районах районам район
минимальный: минимальны
факт: фактов
количество: количество
древние: древних
миля: миль
покидать: покидают
дуга: дуге дуги
нырять: ныряет
убивать: убивает убивать
скудость: скудость
изнеможение: изнеможения
уступать: уступают
показано: показано
собака: собаками
необходимость: необходимости
возможный: возможно возможных
вполне: вполне
находившихся: находившихся
редкий: редко
прохладный: прохладных прохладным
характеризоваться: характеризуется
сценарий: сценарию
толстороги: толстороги
уставать: устают уставать
жидкий: жидкого
дэвида: дэвида
дополнительный: дополнительных
получиться: получилось
усталый: усталыми
впоследствии: впоследствии
документ: документов
ранее: ранее
спортивный: спортивные
примечательный: примечательно
функция: функции
ответ: ответы
найтись: нашлись
оставляя: оставляя
падальщиками: падальщиками
окупиться: окупятся
тема: темой
английский: английском
общество: обществ обществах
шумный: шумными
процент: процент
оказываться: оказываются
записаны: записаны
лисица: лисицы
родной: родных
ценный: ценные
испарение: испарение
повторяться: повторяется
проваливаться: проваливается
палящий: палящим
эвенк: эвенки
наверняка: наверняка
множество: множество
сопротивление: сопротивления
культурный: культурной
делать: делать делают
карохи: карохи
мясо: мясом
ним: ним
кенгуру: кенгуру
обнаруживаться: обнаруживаются
хороший: хорошие хорошую
ленивый: ленивой
поверить: поверить
достаточный: достаточно
неэффективности: неэффективности
четвероногий: четвероногих
внушительный: внушительную
занятие: занятие
тайга: тайгу
цикл: цикл
охотник: охотник охотников охотниками охотника охотники охотникам охотнику охотниках
физический: физических физическую
общий: общей
целый: целый целыми
особый: особым
километр: километр
четко: четко
пробежка: пробежками пробежку
убедительный: убедительна
вроде: вроде
поддерживать: поддерживать
бежать: бегу бежать бежит бежим
поиск: поиск поисках
мочь: могли
объясняться: объясняется
задолго: задолго
появиться: появились
полный: полного полный
удалось: удалось
охотиться: охотились охотиться
догнав: догнав
встречаться: встречается
запад: запад
судорожный: судорожных
земля: земля
бесполезный: бесполезно
тащить: тащить
догнать: догнать
способствовать: способствуют способствует способствовали
защищать: защищает
рывок: рывки
дождь: дождей дождя
паразит: паразитами
сан: сан
этнографические: этнографические
судан: судан
отчасти: отчасти
человеческий: человеческие человеческих
привязано: привязано
практиковаться: практикуется
касаться: касается
выходить: выходит
доводя: доводя
многие: многим многом многих многие
удивительный: удивительный
наступление: наступления наступлением
минута: минут
собрать: собрать
настигнуты: настигнуты
трудный: трудно
отчетах: отчетах
млекопитающий: млекопитающими млекопитающим
сокращение: сокращением
рамка: рамках
бегун: бегуны бегунов
всякий: всякая
немецкий: немецком
подгонялось: подгонялось
колено: колено
обсуждаемой: обсуждаемой
использовать: использовали используют
дело: делом
проведенный: проведенный
соплеменник: соплеменники
предпочитать: предпочитают
единый: единого
нога: ног ногах ноги
условие: условиях
слово: словам
трекера: трекера
антрополог: антропологами антропологи антропологов
выраженный: выраженный
опубликованной: опубликованной
сложность: сложности
сухой: сухого сухую
минимум: минимуму
отбор: отбору
источник: источник
охлаждать: охлаждает
итальянский: итальянском
коллекция: коллекцию
рука: руки
ровный: ровно ровный
выбрать: выбрать
ясный: ясно
обитаемый: обитаемых
тренированный: тренированные
ломать: ломает
старый: старых старый старое
резкий: резко
эффективный: эффективным эффективно
томсона: томсона
идет: идет
оружие: оружие оружия
ботсвана: ботсвана
этнографической: этнографической
уважение: уважением
роль: роль роли
сеть: сеть
всевозможный: всевозможных
причина: причин
форма: форму
сделать: сделать
недоизученность: недоизученность
бег: беге бега бег
инженерный: инженерное
возражение: возражения
невероятный: невероятными невероятно
длинный: длинные
серьезных: серьезных
уинтерхальдер: уинтерхальдер
лангване: лангване
часть: частей часть
адаптированными: адаптированными
нашим: нашим
болото: болото
бумажных: бумажных
гоняться: гоняются
представление: представления
адаптируясь: адаптируясь
конкурировать: конкурировать
плохой: плохие
жираф: жирафов
свидетельство: свидетельств
лесистый: лесистой
известный: известны известно
камень: камням
вопрос: вопросом
калахари: калахари
определяться: определяется
погода: погоду
путь: путь
фильм: фильма фильм
порядок: порядка порядок
человек: людей человека людям
оправданный: оправданным
водянистый: водянистого
жаркий: жарких
развернутые: развернутые
регион: регионах регион
настойчивость: настойчивостью
реальный: реальное
определенные: определенные
глубокий: глубокий
согласный: согласно
современный: современных современные
успех: успех успехом
лагерь: лагерь лагерю
преследования: преследования
подобраться: подобраться
некрупный: некрупные
хитрый: хитрых
показан: показан
упражнение: упражнения
оджибве: оджибве
преувеличено: преувеличено
половина: половины
кожа: кожу
иметь: имеют имеет
отдавать: отдают
связана: связана
спокойный: спокойно
исчезнуть: исчезли
хотеть: хотел
медленный: медленных медленно
отсутствие: отсутствие отсутствию
измождение: измождение
выстрел: выстрела
расширяющих: расширяющих
цениться: ценилась
потовой: потовых
местность: местности
править: правило
поистине: поистине
мужчина: мужчины
образ: образом
распространиться: распространилась
намного: намного
учесть: учесть
копьем: копьем
охотничий: охотничьи
дать: дали
загнать: загнать
одному: одному
база: базах
продолжать: продолжает
знание: знание
вытащить: вытащил
выбирать: выбирали
отношение: отношении
каждый: каждом каждым
оценка: оценки
пастись: пастись
должный: должна должны
осень: осенью
сила: сил силами
отмечать: отмечают
коренной: коренных коренные
охватывать: охватывают
неуклюжий: неуклюжими
стайер: стайеры
большой: большое большой
усиленный: усиленно
морэн: морэн
гипотеза: гипотез гипотезы гипотеза гипотезой
например: например
стадо: стадом
бегущий: бегущий
серьезные: серьезные
абстрактный: абстрактными
тщательный: тщательный
феномена: феномена
идея: идеи
входной: входных
гавайи: гавайи
хижина: хижине
отчет: отчет
северо: северо
следуя: следуя
проект: проекта
наталья: наталья
ограничиваться: ограничивается
некоторые: некоторые некоторыми
май: мая
моделирование: моделировании
показывать: показывают показывает
начинаться: начинается
проживание: проживания
практик: практика
спринтер: спринтеры
увидеть: увидишь
собиратель: собирателей собирателями собиратели
дыхание: дыхания дыханию дыханием дыхание
предприятие: предприятием предприятия
применить: применить
постоянный: постоянной
случай: случаев
бернд: бернд
приведен: приведен
полуживой: полуживое
данные: данных данные
способ: способом способ способов
точка: точки
оставаться: остаются
сибирь: сибирь
россия: россия
здоровый: здоровые
удивление: удивление
сильный: сильно сильными
сокращаться: сокращаются сокращается
предположение: предположение
вилороги: вилороги
отчете: отчете
догонять: догоняет
приближаться: приближается
прочить: прочь
подвергаться: подвергались
адаптация: адаптация адаптации
баланс: баланса
выделяющих: выделяющих
пола: поле
