профилактика: профилактики
фузарии: фузарии
определить: определили
роль: роль
добавлять: добавлять
фунгициды: фунгициды
продолжать: продолжать
растение: растений растения растение растениях растением
простота: простота простоте
популярный: популярным
противомикробными: противомикробными
давление: давления
рацион: рацион
постоянный: постоянно
продуцирует: продуцирует
отмерших: отмерших
макроконидии: макроконидии
метаболитов: метаболитов
америка: америки америке
поскольку: поскольку
обнаруженная: обнаруженная
помимо: помимо
патогенный: патогенных
относительный: относительной
значимый: значимо
избыточный: избыточных
устойчивый: устойчив устойчивых
вполне: вполне
ущерб: ущерб
последующий: последующим
годах: годах
практически: практически
статья: статьи статья
оценка: оценки
овощной: овощных
проводящих: проводящих
проблема: проблему
аминокислота: аминокислота
субэпидермальных: субэпидермальных
ситуация: ситуациях
треть: треть
прежде: прежде
прекрасный: прекрасной
угроза: угроза угрозой
объемы: объемы
почва: почву почвы почве
биоконтроля: биоконтроля
патогены: патогены
осознать: осознали
кулинарный: кулинарный
потенциал: потенциал потенциалом
обстоятельство: обстоятельствах
фермер: фермерами
гриб: гриб грибы грибов
окраска: окраску
саженец: саженцами
тепличный: тепличных
собранный: собранная
результат: результаты
отмечать: отмечают
метода: метода методам метод методы
сосудистый: сосудистой сосудистую
верхушка: верхушек
участок: участков
необходимый: необходимого
вызываемое: вызываемое
рост: рост
расти: растут
целый: целом
вызывая: вызывая
агротехнический: агротехнические
борьба: борьбы борьбе
механизм: механизмы механизмах
находиться: находятся
способность: способности
вырабатывать: вырабатывают
микроконидий: микроконидий
экстрагирования: экстрагирования
сайт: сайта
стимулировать: стимулирует стимулировать
фермент: ферментов ферменты
плантация: плантации
распространенного: распространенного
плодоношение: плодоношения
производится: производится
водоросль: водорослей водоросли водоросль
показать: показали
разрушать: разрушать
высушивание: высушивания
выращивать: выращивали выращивать
декоративный: декоративных
вызываемой: вызываемой
патогенов: патогенов
возможный: возможна
фузариевую: фузариевую
либо: либо
проникая: проникая
исследовать: исследуют
стенка: стенку
хромато: хромато
особенность: особенность
обмен: обмена
урожай: урожая
задействованы: задействованы
разработка: разработки
устойчивость: устойчивости
период: период периода
днем: днем
день: дней
некроз: некрозом
молодой: молодых
ранее: ранее
ацетоновый: ацетоновых
опубликована: опубликована
влажность: влажности
патогена: патогена
перегородка: перегородки
удаление: удаление
важный: важно
этанольных: этанольных
точный: точно
рекомендоваться: рекомендуется
пропенил: пропенил
фузариозное: фузариозное
заболеваемость: заболеваемость
симптом: симптомы
португальский: португальские
стебель: стеблям стебля
снижать: снижает
определенные: определенные
проводить: проводили
инокуляция: инокуляции
изоэспинтанол: изоэспинтанол
растительный: растительных
изображение: изображение
защитный: защитные защитных
уничтожить: уничтожила
тургора: тургора
этилацетатовый: этилацетатовый
испанский: испанские
эпидермис: эпидермис
клетка: клетки клетках
посредство: посредством
глубокий: глубже
определять: определяли
играть: играет
основный: основных
обозначаться: обозначаются
мероприятие: мероприятия
поддержание: поддержания
участвовать: участвуют
ход: ходе
время: времена
глюканазы: глюканазы
стресс: стрессу стресс
естественный: естественные
диковинка: диковинок
кавендиш: кавендиш
корень: корня корни корней
впервые: впервые
достигать: достигать
возникать: возникают
вызов: вызовы
абиотическому: абиотическому
пожелтением: пожелтением
проявляться: проявляется
массовый: массового
декстрозном: декстрозном
масштабный: масштабного
бензольных: бензольных
осторожный: осторожно
теплица: теплице
фузариозного: фузариозного
характерный: характерную
род: рода родов
полный: полной
формируется: формируется
метокси: метокси
защита: защиты
фузарией: фузарией
повышать: повышает
листва: листву
достаточный: достаточно
форма: формой форм
заболевание: заболевания
обозначение: обозначения
безусловный: безусловно
стоять: стоять
антигрибковых: антигрибковых
автор: авторы
средиземноморья: средиземноморья
передающиеся: передающиеся
место: местах место
увеличиваться: увеличивается
общий: общего общая общее
значительный: значительно
стать: стать
открытый: открытом открыт
справа: справа
технология: технологий
штамм: штамм штаммов штаммы
демонстрировать: демонстрируют
акцент: акцент
южный: южной
заражать: заражать
соответствие: соответствии
отсутствие: отсутствия
данный: данного
эффективный: эффективным
повышение: повышение
триходермы: триходермы
бурый: бурых
активировать: активирует
хлорофилла: хлорофилла
наносить: наносить наносили
одна: одна
известный: известны
потеря: потерей потери
массы: масс
внешний: внешний
внесенный: внесенный
спороношение: спороношение
исследование: исследования
концентрация: концентрация концентрацию концентрации
грибковый: грибков грибковые
производство: производства
меньшой: меньшим
фунгицидными: фунгицидными
немаловажный: немаловажную
функция: функциях
поначалу: поначалу
крепиться: крепятся
возрастающий: возрастающую
перспективный: перспективны
выработка: выработку выработки
фитофтороз: фитофтороз
сосуд: сосудов
проводиться: проводиться проводились
высокий: высокую выше
поглотитель: поглотители
специализированной: специализированной
кислота: кислоту
учитывая: учитывая
этилацетатных: этилацетатных
грунт: грунте
бактерия: бактерий бактерии
колонизатор: колонизаторы
дальнейший: дальнейшем дальнейшего
фенольные: фенольные
который: котором
являться: является
контроль: контроля контроль
больший: большую большем
хитиназы: хитиназы
изучается: изучается
установить: установили
накапливаться: накапливаются
пероксидазы: пероксидазы
быстрый: быстро
отличаться: отличается
подкормка: подкормке
начало: начале
колонизировать: колонизирует
этилацетатный: этилацетатный
фенол: фенол фенолов фенола
гибрид: гибридов
поражение: поражения
лист: листья листьев листьях
считаться: считались
индустрия: индустрию
настать: настали
тёмный: темно
белый: белого
полив: поливе
стрелка: стрелкой
эффективность: эффективность
счет: счет
распространены: распространены
зависимость: зависимости
побег: побегов
хлороформных: хлороформных
цианобактерий: цианобактерий
вошел: вошел
сельскохозяйственный: сельскохозяйственных
английский: английским
ареал: ареал
соответствующий: соответствующую
рис: рис
стабильный: стабильно
первый: первую первые
регион: региона регионах
вид: виды видов вид виде
ним: ним
группа: групп группах
серьезная: серьезная
отдельный: отдельных
спектрометрия: спектрометрии
свойство: свойствами
оксид: оксид
обсуждаемой: обсуждаемой
сельский: сельского
альтернариоз: альтернариоз
коричневый: коричневую
например: например
рамка: рамках
плод: плоды
совершенствование: совершенствование
черешков: черешков
помощь: помощи
море: море
антиоксидантных: антиоксидантных
несъедобный: несъедобными
материал: материала
слева: слева
содержание: содержание содержанию
любитель: любителей
ткань: ткани ткань тканей тканях
понять: понять
мировой: мировом
хлорозом: хлорозом
цвет: цвета
клеточный: клеточную
острый: остро
джорджем: джорджем
отмечена: отмечена
фунгицидов: фунгицидов
биотическому: биотическому
показательный: показательна
делиться: делятся делились
стрессовых: стрессовых
пестициды: пестицидам
оказаться: оказались
альтернатива: альтернативой
пластинка: пластинок
ночь: ночью
действовать: действуют
мицелий: мицелия мицелию
колония: колония
степень: степени
банан: бананами
морфологический: морфологические
листовых: листовых
иметь: имеют
осмотический: осмотического
газовый: газовой
улучшить: улучшил
европеец: европейцы
буквальный: буквально
преодолевать: преодолевать
распространяться: распространяться
состоящее: состоящее
использовалась: использовалась
вносить: вносили
пролина: пролина
судить: судить
зараженные: зараженные
антагонист: антагонистов антагониста
развивать: развивать
температура: температуре
эвгенол: эвгенол
возделывания: возделывания
развиваться: развивается
производятся: производятся
обоих: обоих
источник: источники
гифа: гифа
настоящий: настоящее
познакомиться: познакомились
житель: жителей
вынудив: вынудив
возбудитель: возбудитель возбудители возбудителей возбудителем возбудителя
распространяясь: распространяясь
розовый: розового
положительный: положительно положительном
протравливание: протравливание
семенной: семенного
признак: признаки
говорить: говорят
раса: расы раса
связаны: связаны
субстрат: субстратов
печь: печи
макроводоросли: макроводоросли
нижний: нижних
приводя: приводя
севооборот: севооборота
экологический: экологической
писать: пишут
знакомая: знакомой
патогеном: патогеном
будущий: будущем
водный: водных
количество: количестве количества
септориоз: септориоз
почвенный: почвенного почвенным
делать: делают
вещество: веществ вещество
фузариозом: фузариозом
называемой: называемой
деформация: деформация
картофельно: картофельно
эксперимент: эксперименты эксперименте
видный: видно
состояние: состояние
активный: активно активных
обеззараживание: обеззараживание
пролин: пролин
увеличение: увеличение
подвергающихся: подвергающихся
сорт: сорта сорт сортов
полевой: полевых
прежнее: прежнее
самый: самым
зараженных: зараженных
шейкина: шейкина
центральный: центральной
относить: относят
зеленых: зеленых
четырехнедельными: четырехнедельными
специальный: специальной
атака: атаке
соединение: соединения
недавний: недавней
нумеруются: нумеруются
повсеместный: повсеместно
агаре: агаре
число: числе
направление: направлении
культура: культур культуру
кора: коры
патоген: патоген
термический: термическое
течение: течение
шкала: шкалы
исчезновение: исчезновения
очередь: очередь
описанный: описано
образец: образцах
грибок: грибком грибка
тревожный: тревожные
уязвить: уязвим
поражать: поражать поражает
проникновение: проникновения
использование: использование
масштаб: масштабе
инфекция: инфекции
кариофиллена: кариофиллена
ген: гены
гибель: гибели
метанольных: метанольных
добавляться: добавлялся
применение: применения применение
способствовать: способствует способствуют
продовольственный: продовольственной
ряде: ряде
слой: слоях
здоровый: здоровых здоровым здоровые
середина: середине
микологом: микологом
физиологические: физиологические
пораженных: пораженных
остается: остается
средство: средством средств
показано: показано
гро: гро
различный: различных
большой: наибольший
соблюдение: соблюдение
диэтилэфирных: диэтилэфирных
панамской: панамской
причинять: причинять
обладать: обладают
факторов: факторов
увядание: увядание увядания увяданию
культуральные: культуральные
классический: классических классические
применять: применяли
предположить: предположить
масси: масси
сегодняшний: сегодняшний
проникать: проникает
влияние: влияние влиянии
отражаться: отражается
экстракт: экстракт экстрактов экстрактом экстракта
привезти: привезли
несмотря: несмотря
банановый: банановую бананов
накопление: накоплению
уровень: уровень
история: история
мишель: мишель
макро: макро
заражение: заражения
снизить: снизить снизила
культивируемыми: культивируемыми
безопасность: безопасности
распространенность: распространенность
джании: джании
верхний: верхним
закрытый: закрытом
пасленовых: пасленовых
получавших: получавших
показавшие: показавшие
ввдения: ввдения
экспериментальный: экспериментальных
наличие: наличия
кислород: кислорода
хозяйство: хозяйства
красный: красной красных красная красном
способный: способен способный способные способны
улучшать: улучшает
век: века
резистентности: резистентности
длина: длины
весьма: весьма
болезнь: болезни болезнь болезней
обширный: обширные обширным
усыханием: усыханием
работа: работе работ
паразитический: паразитическим
скручивание: скручивание
внекорневой: внекорневой
вручную: вручную
полифенолоксидазы: полифенолоксидазы
колумбова: колумбова
поверхность: поверхности
условие: условиях
химический: химический
вегетационный: вегетационного
ацетат: ацетат
обработка: обработку обработка
вопрос: вопросы вопрос
определенных: определенных
опыт: опыт
нанесение: нанесение
томат: томатов томатом томата томат томаты
изначальный: изначально
ученые: ученые
испытуемый: испытуемые
зараженным: зараженным
фото: фото
новый: нового новые
приготовленный: приготовлен
реагировать: реагирует
метод: методов
некоторые: некоторых
вспышка: вспышка
цифра: цифрами
особый: особый
биологический: биологических биологический биологического
цель: целях целью
переключиться: переключиться
возвращение: возвращение
вера: вера
