череда: череде
затрачиваемое: затрачиваемое
полезный: полезные
остаться: осталось
найти: найти
технический: технического
самый: самых самые
антропогенной: антропогенной
включать: включает
процесс: процессе
самка: самка самок самки
колка: колки колка колке
скорый: скорее
второй: втором второго
происхождение: происхождении
мерка: меркам
проанализированы: проанализированы
средний: среднем
предпочитаемый: предпочитаемых
ближайший: ближайших ближайшие
доступ: доступ
партнеров: партнеров
груминг: груминг
марков: марков
изменчивость: изменчивость изменчивости
наличие: наличие
опубликовать: опубликовали
одному: одному
расположенный: расположенную
традиция: традиции традиция
диаграмма: диаграмма
целый: целое целом
существовать: существует
накопленного: накопленного
становиться: становится
гений: гения
шимпанзе: шимпанзе
имя: имени имена
выборка: выборке
приматологи: приматологи
видеоархива: видеоархива
который: которым
зависимость: зависимость
каждый: каждой каждому
должность: должность
разнородный: разнородной
свет: свет
набралось: набралось
продолжать: продолжает
предел: пределах
дает: дает
значимый: значимая значимых
труд: труда
наковальня: наковальни наковален
крайний: крайне
говоря: говоря
искать: искали
начаться: начались
доля: доля
данные: данных данные
особь: особи особь особей особями
место: место месте
независимый: независимых
обязательный: обязательное
рассказывать: рассказывали
достижение: достижение
задача: задачей
координация: координацией
выяснение: выяснение
пищевой: пищевому
ресурс: ресурсу
интригующий: интригующие
уникальный: уникальной уникальная
частичный: частичный частичным
учитывались: учитывались
искусство: искусство
участие: участием
корреляция: корреляцию
четырьмя: четырьмя
удалось: удалось
данный: данной
привести: привести
рис: рис
элемент: элементы
затрачиваемому: затрачиваемому
зрелый: зрелых
нюанс: нюансах
хороший: хорошие хорошими
четвертом: четвертом
понимать: понимают
примат: приматов
известный: известно известны
предположение: предположением
растущей: растущей
нагрузка: нагрузки
наоборот: наоборот
обезьяна: обезьян обезьянам обезьяна обезьяны обезьянами
находиться: находится
примерно: примерно
подверждается: подверждается
статья: статьи статье
регистрироваться: регистрируется
подражание: подражания
оценка: оценки
молоток: молоток
важный: важных важен важной
учиться: учиться учились
сентябрь: сентября
верный: верны
посещаемую: посещаемую
сдаться: сдалась
четырем: четырем
инстинкт: инстинкт
орудийный: орудийной
стать: стать
означать: означало
направленность: направленность
момент: момента
племя: племени
старый: старше старые старых
улетанию: улетанию
отражать: отражают отражает
интересный: интересных интересно
вымирание: вымирания
начиная: начиная
сородич: сородичами
стереотипный: стереотипной
съедобный: съедобные
окончательный: окончательного окончательно
показано: показано
образ: образом
неумелый: неумелых
видный: видны
цель: целью
орудие: орудий орудия
значительный: значительная
умелый: умело умелых
дикий: диких
технология: технологии технологию
необходимый: необходимых
статистический: статистический
начинать: начинает начинают
представлять: представляет
сообщение: сообщение
метр: метров
неудачный: неудачных
редкий: редкий реже
пола: полами
человек: людьми
раскалывателей: раскалывателей
подробность: подробностях
завершившихся: завершившихся
друг: друг
факт: факт
согласоваться: согласуется согласуются
теоретик: теоретиками
остальное: остальные остальным остальными
середина: середине
александр: александр
сбивающих: сбивающих
приводящих: приводящих
очередь: очередь
течение: течение
параметр: параметры
заканчиваться: заканчивается
сложность: сложности
закончиться: закончились
ядро: ядро
имеющийся: имеющиеся
существенный: существенных
троить: троим
молотковый: молотков
многие: многие
немощь: немощи
снижаться: снижаться снижалась снижаются снижается
первый: первого первые первое первых
точность: точности
устойчивость: устойчивости
занятие: занятия
эпизод: эпизоды эпизод эпизода эпизодов
общий: общей общую
крошка: крошки
меньший: меньшее
комбинация: комбинацией
масличный: масличной
интерпретация: интерпретации
рисунок: рисунок
опыт: опыта
результат: результата результаты результат
камень: камней камни камнем камень камнями
навык: навыка навыков навык
период: период
вполне: вполне
разум: разума
колоть: колют кололи колола
высокотехнологичного: высокотехнологичного
фанле: фанле
босс: боссу
начальный: начальных
индивидуальный: индивидуальная индивидуальные
находясь: находясь
вопрос: вопрос вопросы
явление: явление
рабочая: рабочей
камера: камер
ежедневно: ежедневно
коррелируют: коррелируют
остается: остается
источник: источник
пальма: пальмы
раскалывательниц: раскалывательниц
помочь: поможет
шаг: шагов
раскалывать: раскалывать
возрастной: возрастным возрастных
жизнь: жизни
подходящий: подходящие
поэтому: поэтому
вымереть: вымрет
практически: практически
слетать: слетать
старость: старость
следующий: следующий
хотеться: хотелось
гранить: грани
численность: численность численности
успех: успех успехом
приспособленность: приспособленность
видео: видео
наблюдение: наблюдений наблюдения
эффективность: эффективности эффективность
основа: основе
жалить: жаль
двух: двумя
секунда: секунд
вряд: вряд
пространный: пространно
влиять: влиять
показатель: показателей показателям показателя показатель
личной: личного
различие: различия различиям различий различие
моторный: моторных
летний: летнего
возможный: возможно возможен
молодой: молодые
размышляющими: размышляющими
прогрессивный: прогрессивной
когнитивный: когнитивных
различаться: различаются
размозжить: размозжила
делать: делают
отбор: отбора отбор
небо: небом
территория: территории
прежнему: прежнему
сниматься: снимается
естественный: естественной естественный
годам: годам
показать: показал
частность: частности
плохой: плохо
участвовать: участвовали
изучение: изучение
вместе: вместе
эволюция: эволюции эволюцию
обстановка: обстановке
изобретение: изобретений
умение: умение
приобретенный: приобретенный
маленький: маленькое
оказаться: оказалось
предпосылка: предпосылкой
открытый: открытым открытую
улучшение: улучшению
малый: малого
отбирались: отбирались
природа: природа
слева: слева
ловкий: ловко
причем: причем
динамика: динамика
густой: густой
интервал: интервалов интервала
отношение: отношений
тратить: тратит
обсуждаемой: обсуждаемой
зрелость: зрелости
возможность: возможностей
таблица: таблице
движение: движений
ценный: ценному
идет: идет
сводиться: сводится
жуткий: жуткое
ракурс: ракурсов
половой: половым половых
сравнение: сравнению
исследование: исследований исследование исследованиями
изолировано: изолировано
признак: признаков
группа: группы группе групп
шимпанзиным: шимпанзиным
разный: разных
случай: случаях случаев
осколок: осколков
характеристика: характеристику
курьез: курьез
удар: ударов удара
секрет: секретом
выясниться: выяснилось
вездесущий: вездесущее
неловкий: неловких
альфа: альфа
какой: каких каком
наследование: наследование
умрет: умрет
член: членов
фото: фото
недостаточный: недостаточно
годы: годы
ранний: ранние
забота: забота
культурный: культурной культурные культурная культурное
работа: работы
японский: японские
происходить: происходит
ученик: учениками
лаборатория: лабораторию
наблюдатель: наблюдатели
положительный: положительно
старческий: старческой
выявлены: выявлены
этап: этапы
выявление: выявление
сожаление: сожалению
процедура: процедура
частота: частота
обучаемостью: обучаемостью
находящемся: находящемся
использование: использования
добиться: добиться
накопленных: накопленных
иметь: имеет
связанный: связанной связанных
полный: полный полным
трава: травой
борьба: борьба
модель: модели
размер: размером
шестилетний: шестилетнего
самец: самцов самцы самец самца
выяснить: выяснить
наносить: наносит
глубокий: глубокая
соприкоснуться: соприкоснулся
являться: являются является
прятаться: прячутся
использовалось: использовалось
активный: активное
вероятный: вероятно
смысл: смысл
видеозаписей: видеозаписей
последний: последние последний
успешный: успешно успешных
теоретически: теоретически
сообщество: сообществе сообщество сообществом сообщества
продолжение: продолжение
число: число числу числа
возраст: возрасте возраста возрастом возрастах
высший: высшее
снимать: снимают
родствеников: родствеников
одна: одна
дальнейший: дальнейшем дальнейшее
многократный: многократных
статус: статус
формирование: формирования
например: например
хватать: хватает
выбирать: выбирала выбирать
смена: смены
справляться: справляться справляются
коррелирует: коррелирует
потомство: потомстве
сложный: сложной
культура: культуры культура
оптимальный: оптимальным
расколоть: расколоть
очевидный: очевидно
гвинея: гвинея
занесен: занесен
британский: британские
понимание: пониманию
небольшой: небольших
животное: животных
многолетний: многолетних
деятельность: деятельностью деятельности
владеть: владеет
проведенное: проведенное
сильный: сильно сильны
показывать: показывает
устойчивый: устойчивыми
условие: условие
обусловленный: обусловлена
другой: другом другую
приведены: приведены
турнирный: турнирной
изолированный: изолированное
помощь: помощи
попытаться: попытались
семеро: семеро
трем: трем
одни: одни
ситуация: ситуации
совершенствовать: совершенствовать
менять: меняют менять
большинство: большинство
пять: пяти
иллюстрирующая: иллюстрирующая
автор: авторы авторам
рассуждать: рассуждают
быстрый: быстро быстрее
растет: растет
поведение: поведение
уверенный: уверенного
расколоться: раскололся
конкретно: конкретно
дол: доле
открывать: открывает
видимый: видимому
систематический: систематические систематически
продолжительность: продолжительность
попытка: попыток
наступление: наступления
колет: колет
пример: пример примера
конфликтовать: конфликтовать
журнал: журнале
влияющих: влияющих
насколько: насколько
пришлый: пришлая
ловкость: ловкостью
дествительности: дествительности
память: памяти
конец: конца
продолжаться: продолжается
ребёнок: детей
поколение: поколений
ним: ним
мочь: могла
способность: способностей способность
специальный: специальную специальными
площадка: площадку
занимать: занимает
третий: третьем
орех: орехи орехов орех ореху орехом ореха орехами
корректный: корректной
молотый: молота
надежда: надежды
пользоваться: пользуются
анализ: анализ анализа
раскалывание: раскалывания
неудача: неудачей
наших: наших
сохраняться: сохраняются сохранялось
ученые: ученые
сайт: сайта
занимавший: занимавший
полова: половой
ответ: ответ ответа ответы
шести: шести
низкий: низкой
некий: некую
эффективнее: эффективнее
считаться: считалось
четырех: четырех
обучение: обучения обучение
скорлупа: скорлупы
годах: годах
создать: создали
обезьяний: обезьяньего
ход: ход
присоединиться: присоединилась
совершенствоваться: совершенствуется совершенствоваться
добыто: добыто
обогнать: обогнала
пролить: пролить
класть: кладут
