разобраться: разобраться
прикладываемых: прикладываемых
обозначать: обозначают
стен: стен
бегать: бегать
ручка: ручки
тыкаться: тыкались
графике: графике
напротив: напротив
больший: большие большая
крупный: крупные крупную крупных
связано: связано
скорость: скорость
наталкиваться: наталкивается
маршрут: маршрут маршрута
пианино: пианино
особь: особей особи
результативность: результативности
рывок: рывков
ранний: раннего
покоряться: покоряется
дополнительный: дополнительной
такой: таким таких такого
транспортировка: транспортировки
проинструктировать: проинструктировали
компьютерный: компьютерная
повести: поведут
говориться: говорится
реховот: реховот
смочь: смог
насекомое: насекомое насекомых
конец: конце концов
храм: храмов
число: числа число
уровень: уровне
перетаскивания: перетаскивания
подтаскивать: подтаскивают
мочь: могли
неудачный: неудачных
завтрак: завтраков
внимание: внимание
запрещать: запрещали
крупногабаритный: крупногабаритный крупногабаритную
муравьиный: муравьиный
человек: людьми человека людей людям
видео: видео
муравьев: муравьев
сообща: сообща
исследование: исследований исследования исследование
мимика: мимики
присущий: присущую
глобальный: глобальные
вместе: вместе
сравнение: сравнению сравнения
квартира: квартире
разный: разную разной
записывать: записывали
весьма: весьма
учитывались: учитывались
рациональность: рациональность
называть: называют
экспериментальный: экспериментальные
наименьший: наименьшего
считать: считают
возникать: возникает
проект: проект
амбициозный: амбициозную
кусочек: кусочек
шестиногих: шестиногих
приниматься: принималась
заведомый: заведомо
обобщение: обобщение
огюст: огюст
небольшой: небольших
действующий: действующие
коллега: коллегам
одинаковый: одинаковом
положение: положение
понимать: понимают понимали
вернувшись: вернувшись
роль: роль
вспомнить: вспомним
изложенные: изложенные
пройденного: пройденного
ученых: ученых
жильё: жилье
нашего: нашего
передвинуть: передвинуть
похожий: похожих
выработка: выработку
цензура: цензуры
фото: фото
процесс: процессе
принять: приняли
действуя: действуя
вход: входу
стать: стала
задвигают: задвигают
поведение: поведение
влияние: влияние
функция: функция
благодаря: благодаря
масса: масса
приблизительный: приблизительно
высокий: выше
пропадать: пропадает
новый: новый новым новую новых
определить: определить
напрямую: напрямую
поперечина: поперечиной
отдельность: отдельности
перестает: перестает
параллельный: параллельных
систематический: систематически
добровольный: добровольно
тащить: тащат
волочить: волочить
форма: формы
измерять: измеряли
оценивался: оценивался
находиться: находился находятся
умный: умнее
ошибочный: ошибочным
корм: корма кормом
результат: результатом результат результаты
неудивительный: неудивительно
пластик: пластика
совершать: совершала
зависимость: зависимости
координация: координация
образный: образной
помогать: помогает
народ: народе
равный: равные равно
переноска: переноску переноски переноске
безуспешный: безуспешной
журнал: журнале
остальное: остальные
иметь: имели
соврать: соврать
полоса: полоса
кусок: куски
удается: удается
пищевой: пищевой
данные: данные
буква: буквы
справляться: справлялись
минимальный: минимально
выбранный: выбранный
молчать: молчать
муравей: муравей муравьи муравьям муравьями
участие: участию
пройти: прошли
неочевидные: неочевидные
поделать: поделаешь
втащить: втащить
индивидуум: индивидуума
правильный: правильную
определяться: определялось
кот: кота
соответственный: соответственно
увеличение: увеличением
политика: политике
коллективный: коллективный
сопоставить: сопоставить
узкий: узкому
участвовать: участвовали
оценить: оценить
расти: росла
метафора: метафора
общество: обществом общества
миска: миски
впечатлились: впечатлились
сохраняться: сохраняется
сопоставление: сопоставления
продолжаться: продолжается
обмен: обмен
последовательность: последовательность
отцепляясь: отцепляясь
счет: счет
поставить: поставить
длина: длине длина длину
например: например
действовать: действовать
принимаемых: принимаемых
план: план
красть: крадут
оставлять: оставляет
демонстрирующая: демонстрирующая
отказываться: отказываться
изменить: изменить
знаменитый: знаменитые
нескоординированные: нескоординированные
снижаться: снижается
сайт: сайта
быстрый: быстрые
сравнивать: сравнивают
показаны: показаны
функционировать: функционировать
успешный: успешного успешными
находить: находить
многие: многие
конформистским: конформистским
нуль: нуля
состояние: состоянии
приводить: приводит
нынешний: нынешнее
помочь: помог
вертеться: вертелись
упираться: упирается
падать: падает
образ: образом
личность: личности
впустую: впустую
велеть: вели
попрешь: попрешь
ведет: ведет
коммуникация: коммуникацию коммуникация
самый: самым
пройденный: пройденный
ноша: ноше ношу ношей ноши ноша
смоделировать: смоделировали
побегав: побегав
считаться: считалось
автор: авторы
существенный: существенное
задний: задний
сотрудник: сотрудник сотрудники
вопреки: вопреки
название: названию
поставиться: поставили
одиночка: одиночка одиночки
вертикальный: вертикальные
напролом: напролом
напрашиваться: напрашиваются
случай: случае случаях
пространство: пространство
целить: цель
вдоль: вдоль
условие: условиях условия
объект: объект объектов
система: системы
отцепляются: отцепляются
двигаться: двигался
выстраивать: выстраивают
корректировать: корректировать
предназначенный: предназначенному
операция: операций
возобновиться: возобновиться
смелый: смелое
эдвард: эдвард
камера: камеру
тунец: тунцом
вывод: выводы
тратить: тратили
муравейник: муравейник
вскоре: вскоре
информация: информация
воля: воле
получаться: получается
отношение: отношении
непродуктивный: непродуктивных
член: члены
поиск: поиске
пытаться: пытаться пытается пытаются пытались
примерно: примерно
царь: царя
решение: решения решение решений
рука: руками
подлаживаться: подлаживаются
получать: получают
источник: источник
обсуждение: обсуждение
перемещение: перемещение
сподвигли: сподвигли
словесная: словесная
окружающий: окружающее
род: рода
принимать: принимают
идти: идти
прямой: прямые
переместить: переместить
тянуть: тянуть
переговариваться: переговариваться
помощь: помощью
рациональный: рационально
отверстие: отверстия
поэтому: поэтому
решать: решают решать
кратковременный: кратковременную кратковременной
превращать: превращать
заметить: заметил заметили
отдельный: отдельные отдельными отдельный отдельной
множество: множеством
перспективный: перспективного
оказавшись: оказавшись
противопоказан: противопоказан
начать: начать
эксперимент: эксперимент эксперименте эксперимента
расположенный: расположенный
основа: основе
посредство: посредством
эффективный: эффективные эффективно эффективным
собственный: собственного
думать: думали
поставлены: поставлены
хороший: лучший
насчитывающие: насчитывающие
оказывать: оказывать
безропотный: безропотный
помимо: помимо
перебежка: перебежки
проверять: проверял
транспортировать: транспортировать
начинать: начинает начинают
соломона: соломона
смазав: смазав
состоящих: состоящих
иначе: иначе
хаотичный: хаотичные хаотично хаотичных
ученые: ученые
сторона: сторону
выполнявший: выполнявший
усилие: усилий
приобретать: приобретают
гнездо: гнездо гнезду
сквозь: сквозь
коллективизм: коллективизм
мнение: мнениями мнением
необходимый: необходимых необходимые
курс: курс
вид: вида виде
пролету: пролету
надеть: надели
ситуация: ситуацию ситуации
коммуницировать: коммуницировать
государственный: государственной
группа: группы группа группами группах групп
направление: направление направлении
статья: статья статьи статье
нести: несут
развернуть: развернуть
ширина: ширине
решив: решив
отличаться: отличаются
ничем: ничем
нигде: нигде
настолько: настолько
скорректировать: скорректировать
сверху: сверху
поодиночке: поодиночке
прежде: прежде
индивидуальный: индивидуальные
распределение: распределения
когнитивный: когнитивных
сумасшедший: сумасшедший сумасшедшими сумасшедшие сумасшедшим сумасшедших
израильский: израильских израильском
винтик: винтик
безвозмездный: безвозмездной
движение: движения движений движение
достичь: достичь
кошачьи: кошачьим
прицепляясь: прицепляясь
численность: численности
каждый: каждом
приделать: приделали
конформистами: конформистами
груз: груз грузов грузы груза грузу грузом
общественный: общественной общественных
запустить: запустили
изображение: изображение
лестничный: лестничному
обоих: обоих
перемещать: перемещали
словесно: словесно
институт: институт института
убедиться: убедиться
специальный: специальный
вновь: вновь
показывать: показывает
протащить: протащить
представитель: представителей
перекрываются: перекрываются
свойство: свойств
состав: составе
оказаться: оказалось
разрешен: разрешен
выясниться: выяснилось
времен: времен
эффектный: эффектный
путь: путь пути
интеллект: интеллект
десяток: десятки
двуногий: двуногих
совершенный: совершенных
сопротивление: сопротивления
свободный: свободный свободно
свой: своему своим
проследить: проследили
хлопья: хлопья
готовый: готовых
мирмекологи: мирмекологи
объединяясь: объединяясь
сгладить: сгладить
средний: среднем средние
линия: линии
стоять: стоит
работа: работы
размер: размерам размер размера
частичный: частично
ним: ним
точный: точно
лада: лад
оптимальный: оптимальный
очки: очки
занести: занести
форель: форель
показать: показал показали
феромоны: феромоны
предпринято: предпринято
ограничена: ограничена
хватать: хватают
который: которым
дать: дадут
пронос: проноса
челюсть: челюстями
александр: александр
одну: одну
снять: снял
увиденным: увиденным
другой: другим другом
близкий: ближе
плохой: хуже
стенка: стенок стенки
рассуждение: рассуждению
прямолинейный: прямолинейно
рис: рис
ненадолго: ненадолго
консервированным: консервированным
область: область
бестолковый: бестолковые
устроиться: устроился
тело: тела
серый: серые
пунктирный: пунктирные
разум: разум
совместный: совместное
рассчитанный: рассчитан
общаться: общаться
город: городе
жилец: жильцы
колечко: колечки колечко
актуальный: актуальной
человеческий: человеческие человеческий человеческих
слепой: слепой
машина: машины
удаться: удастся
суть: сути
дергаться: дергаться
подобный: подобного
охотный: охотно
поступать: поступать
пытаясь: пытаясь
коллектив: коллективы коллектив коллектива
момент: момент
разрешённый: разрешена
сразу: сразу
голубой: голубая
разумный: разумно
повернуть: повернуть
застрять: застряла
солнечный: солнечные
грузчик: грузчики
серьезно: серьезно
приходиться: приходится
наблюдая: наблюдая
вовлеченный: вовлеченный
участник: участников участники
симуляция: симуляция
маска: маски
неуспешный: неуспешных
словно: словно
секунда: секунд
установленный: установленную
затруднить: затруднить
относительный: относительная
разделяющего: разделяющего
некоторые: некоторым
манипуляция: манипуляций
способность: способности
сюда: сюда
склонный: склонны
экономика: экономике
ученый: ученый
групповой: групповом
нескоординированного: нескоординированного
нормализована: нормализована
участок: участка
понять: понять
никакой: никаких
обсуждаемой: обсуждаемой
известный: известно
данный: данном
эффективность: эффективность
общий: общей общий
придумать: придумали
задумываясь: задумываясь
поудобнее: поудобнее
возможность: возможность
ненужный: ненужных
первый: первым
рулевой: рулевой
никто: никто
вести: ведут вела
проход: проходов проход проходу
заносить: заносят
используются: используются
сокращающие: сокращающие
препятствие: препятствие препятствием препятствия
координировать: координировать
действие: действия действий действиям
отцепляшки: отцепляшки
опубликованная: опубликованная
попытка: попытки попыток попытка
строение: строению
делая: делая
вейцмана: вейцмана
происходить: происходит
вербальный: вербально
соответствие: соответствии
толкать: толкает толкать толкали
короткий: короткий короткой короче
поддерживать: поддерживают
сравнимый: сравнимы
ход: ходе
пользоваться: пользуются
прекращаться: прекращается
предпочитать: предпочитают
задача: задачу задачи задачей
запоминать: запоминать запоминает
осенить: осенило
добыча: добычу
отпускать: отпускает
тянутый: тянут
различие: различие
жест: жестами
наоборот: наоборот
память: память памятью
сканировать: сканировать
уметь: умеют
исследователь: исследователей исследователи
вероятность: вероятность
перетаскивать: перетаскивают
возможный: возможны
сигнальный: сигнальные
наблюдаться: наблюдалось
уилсон: уилсон
исследовательский: исследовательский
рассчитать: рассчитать
доброволец: добровольцам добровольцев
целенаправленный: целенаправленно
