дышать: дышат дышит
отрезка: отрезка
второй: второго второе
справляться: справляется
сложность: сложность
снизу: снизу
одни: одни
лишённый: лишены
удобный: удобная
тунец: тунца
выглядеть: выглядит выглядят выглядела выглядеть выглядели
свести: свести
гораздо: гораздо
одинаковый: одинаковое
исчезать: исчезать
вызванный: вызванных вызвано
поискать: поискать
сложить: сложили
вид: видами вид вида
отображаться: отображается
другой: другими другим другую
огибать: огибает
установление: установления
пунктирный: пунктирной
верный: верными верно верна
смешиваться: смешивается
стивена: стивена
дальнейший: дальнейшем
обслуживающий: обслуживающие
колебание: колебания
мелкий: мелкими
двоякодышащие: двоякодышащие двоякодышащих
задействованы: задействованы
случать: случай
межень: межень
неспособный: неспособен
выработаться: выработалось
жидкость: жидкости
памятник: памятником
распространены: распространены
автор: авторов
определяться: определяется
помнить: помним
гипоксическим: гипоксическим
опускаясь: опускаясь
десятилетие: десятилетий десятилетие
донный: донных
глотая: глотая
пространство: пространства
асимметричный: асимметричны
прояснить: прояснили
конечный: конечном
замкнутый: замкнутые
ход: ходе хода
ничему: ничему
делиться: делятся
практически: практически
лепесток: лепестки
голубой: голубым
собственный: собственно собственный
маленький: маленькое маленьком мал
тело: тело тела
рогозуба: рогозуба
сбрасывать: сбрасывать
получающую: получающую
обратить: обратим обратила
частичный: частичный частичной частично
подняться: подняться
адаптация: адаптацией адаптация
юго: юго
рудимент: рудимент
описание: описания
париж: париже
газообменных: газообменных
выносящая: выносящая
знак: знак
ветвь: ветвь ветвей ветви
утратить: утратили утратил
предшественник: предшественниками
красный: красным
формирование: формированием
потерявший: потерявший
образоваться: образуются образуется образоваться
гетте: гетте
основный: основной основных основном основным
текст: тексте
сеть: сеть
рогозубу: рогозубу
луи: луи
эдвард: эдвард
помещена: помещена
многоперообразные: многоперообразные
сомнение: сомнений сомнение сомнения
далеких: далеких
рерио: рерио
использовать: использовать использовали
глубокий: глубоких
возникнуть: возникли возник возникло возникнуть
поверхность: поверхности поверхность
поступать: поступает
преувеличивать: преувеличивает
отделаться: отделался
представить: представим
збинека: збинека
адаптированы: адаптированы
белка: белки
запомнить: запомним
называться: называется называются
бесполезный: бесполезен
протоптер: протоптер
регуляторных: регуляторных
эффективность: эффективность
африканский: африканский африканские африканского
близкий: близкой близки ближе
сома: сомы
конструкция: конструкция конструкции
говоря: говоря
попытка: попытки
пересыхающих: пересыхающих
первоначальный: первоначальную
белая: белые
отношение: отношение отношениях
сосуд: сосудов сосуды сосудах
перитонеальной: перитонеальной
отдавшая: отдавшая
омывающей: омывающей
сложный: сложному
путаница: путаница
плавательный: плавательный плавательного плавательным плавательных плавательном
обработанная: обработанная
несостоятельный: несостоятельными
трудность: трудности
полный: полный
камила: камила
водоема: водоема
концентрация: концентраций
физиологическим: физиологическим
известный: известно известны известный
пойдет: пойдет
предложить: предложила
бразильский: бразильская
долгий: долгое
панцирный: панцирная панцирной
критерий: критерия критерий критерием
довод: довод
кожаный: кожаный
появиться: появились
развитый: развиты
выступ: выступ
покойный: покойного
сожаление: сожалению
рис: рис
вовсе: вовсе
вьюн: вьюн
часть: частей часть частью
требующие: требующие
редкий: редкий редко
разделяться: разделяется
данные: данным данных данные данными
например: например
артериальный: артериальной артериальная артериальную артериальных артериальные артериальным артериальное
пескоройка: пескоройка
формироваться: формироваться
смелый: смелую
отнести: отнести
занять: заняла
показывать: показывают
домбровского: домбровского
сегмент: сегмента
коронарный: коронарных коронарными
хаксли: хаксли
охотиться: охотится
оказаться: оказалось оказались оказался окажется
весьма: весьма
встречаться: встречается встречаются
впадавший: впадавший
нормальный: нормальную нормальных
поступающую: поступающую
несомненный: несомненно
морфологический: морфологическим
заново: заново
группа: группы групп группа группах группе
технологический: технологические
функциональное: функциональное
нарушение: нарушения
вред: вред
запад: западе
бразилия: бразилии
нижний: нижней нижние
предположить: предположил
помощь: помощь помощью
лабораторный: лабораторными
писать: писал писали
мезозойский: мезозойского
заполнен: заполнен
тончайший: тончайшие
снабжать: снабжать
называя: называя
стоять: стоит
слой: слой слои
индийский: индийского
требовать: требуют
видный: видна видно видны
видеть: видели
отпечаток: отпечатках отпечатки
южноамериканский: южноамериканской южноамериканские
важный: важную важнее важным важного
вариант: вариантом
кожа: кожа кожи
окружающий: окружающей окружающие
принимать: принимали принимать
двух: двумя
рыба: рыб рыбы рыбам рыба рыбе рыбу
поскольку: поскольку
ответить: ответить
дрозофилы: дрозофилы
главное: главных главное
выбрасывать: выбрасывает
тонкий: тонкими
целиком: целиком
амии: амии
загадка: загадка
чистый: чисто
преимущественный: преимущественно
жировой: жировой
ископаемое: ископаемых
многоперов: многоперов
вопреки: вопреки
кровоснабжение: кровоснабжения кровоснабжение кровоснабжением кровоснабжении
дело: деле дело
исключительный: исключительно
доказать: доказать
показать: показали показал показало показать
прежнему: прежнему
отделять: отделяет
эмбриологические: эмбриологические
смочь: смогли
повод: поводом поводу
складка: складки
говорить: говорим
гипоксических: гипоксических
сердечный: сердечной
оксигенацию: оксигенацию
фрагмент: фрагмента
упомянутый: упомянутый
располагаться: располагается
след: следы следов
перейти: перейти
первичноводного: первичноводного
запускающим: запускающим
мезозое: мезозое
далекая: далекая
целаканта: целаканта
стерлядь: стерляди стерлядь
безлегочная: безлегочная
усилие: усилия
находящийся: находящийся
подсказка: подсказки
представлять: представляет
ниточка: ниточку
особь: особи
желтопузика: желтопузика
молодой: молодых молодую
насекомое: насекомых
никакой: никаких никакого никакой
аналог: аналог
газ: газ
гипоксии: гипоксии
близ: близ
целакантов: целакантов
получше: получше
имеющий: имеющие
образовать: образует образуют
элемент: элементы элементов
остаток: остатки остаток
приносящую: приносящую
молекулярный: молекулярная
уязвимый: уязвимы
лежащего: лежащего
хотеть: хотите
двоякодышащей: двоякодышащей
генетик: генетика
эмбриональный: эмбриональным эмбрионального эмбриональная
боковые: боковые
полость: полость
энергетический: энергетическую
фон: фоне
парности: парности
истинный: истинно
мягкий: мягких
царить: царила
легкими: легкими
спячка: спячку спячки
развиваться: развиваться развивается
тонуть: тонуть
полностью: полностью
находиться: находится находился находятся находиться
тяж: тяжами
водоемах: водоемах
внутренний: внутренним внутренняя
недифференцированной: недифференцированной
предполагаться: предполагается
параллельный: параллельно
сливаться: сливаются
снизиться: снизится
выделение: выделения
заставлять: заставляют
живущий: живущих
объединять: объединяет
кеннета: кеннета
вещий: вещи
доступ: доступа доступ
хвост: хвоста
статья: статьи статей
расположить: расположить
тот: той
обладающей: обладающей
зародышевый: зародышевым
вероятность: вероятность
стадия: стадии стадиях
удовлетворять: удовлетворяет
брайерли: брайерли
метода: метод
середина: середине
хватать: хватает хватало
васнецову: васнецову
шмидт: шмидт
побочный: побочных побочным
стенка: стенки
конец: конце концов
справа: справа
дополнительный: дополнительных дополнительную дополнительным
впрыскивается: впрыскивается
сделанный: сделанный
гигантский: гигантских
гидродинамический: гидродинамический
поток: потоков потоки
пресный: пресных
сульфат: сульфат
существ: существ
отличие: отличий отличие
хвостатый: хвостатые хвостатых
ведущий: ведущее ведущий ведущего
зрение: зрения
верхний: верхней
насквозь: насквозь
двигательный: двигательная
либо: либо
занимать: занимают
южный: южно
вскрытый: вскрытого
дегенерировать: дегенерирует
ввести: ввели
живой: живой живая
будущий: будущих
волновать: волнует
невероятный: невероятно невероятного
желание: желания
биологический: биологическая
рановато: рановато
разрез: разрезе разрез
дать: дал дать
пунктир: пунктиром
начинать: начинают начинает
брюшной: брюшной брюшную
называемое: называемое
перейдет: перейдет
сила: силу
многогранный: многогранна
жить: живут
мешок: мешки мешков мешок
татаринов: татаринов
послужить: послужить
миксин: миксин
разуметься: разумеется
противоречить: противоречат противоречит
домбровский: домбровский
синтетический: синтетическая
свойственный: свойственна свойственный
современный: современных современные современная современным современный современными современного современной
википедии: википедии
проток: проток протока протоком
структурный: структурных
отдавать: отдавать
всевозможный: всевозможные
ночь: ночью
американский: американский американская
центр: центра
парность: парность
позади: позади
эффективный: эффективным
пронизать: пронизать
влияние: влияние
примерно: примерно
приносящая: приносящая
проходящие: проходящие
меря: мере
вымерший: вымершим
весь: всей
ящерица: ящериц
эпителий: эпителий
гидродинамическая: гидродинамическая
дальний: далее
трахея: трахей трахеи
подскакивать: подскакивает
неаэрированной: неаэрированной
служащий: служащая
дожили: дожили
качество: качестве качеств качества качеством качество
становиться: становится
состояние: состояние состояний состояния
гомологии: гомологии
муха: мухи
составлять: составляет
разделение: разделения разделение
начало: начале
свободный: свободные
непересыхающих: непересыхающих
входить: входят
решить: решить
всерьез: всерьез
обозначена: обозначена
физиологических: физиологических
донести: донести
союз: союза
мелового: мелового
речь: речь речи
переместиться: переместились
решение: решения решение
корень: корни
механизм: механизмы механизму
сделать: сделать сделал
заключаться: заключается
чешуйчатый: чешуйчатый
причем: причем
жировом: жировом
зоолог: зоологи
безногий: безногих
лучеперым: лучеперым
предложена: предложена
разделены: разделены
неожиданный: неожиданные
многократный: многократно
глубина: глубинах
потерять: потерял
пластинка: пластинками пластинки
кровь: кровью кровь крови
окунеобразных: окунеобразных
базальную: базальную
присутствие: присутствие
характерный: характерно характерная характерен
понадобиться: понадобились
франсуа: франсуа
модификация: модификацией
порождать: порождают
круг: круга круг круге
минога: миноги миноге миног
подвижный: подвижные
соединительный: соединительно
похожий: похож похожие похоже
зачаток: зачатки
стивен: стивен
соображение: соображения
океан: океана океану
окрашено: окрашено
новый: новая новых
твердые: твердые
дзержинский: дзержинский
кардонга: кардонга
структура: структуре
альтернативный: альтернативная
сравнительный: сравнительная
впереди: впереди
сзади: сзади
минимум: минимуму
среди: среди
ясный: ясного ясно
жаберный: жаберных жаберными жаберный жаберная жаберные жаберном жаберной жаберного
насколько: насколько
атмосферный: атмосферном атмосферному
предотвратить: предотвратить
проходящей: проходящей
погружено: погружено
вскрыть: вскрыть
представитель: представителей
описанный: описаны описана
фауна: фауна
содержать: содержит
развитой: развито
подтверждаться: подтверждается подтверждаются
должный: должна должны
счет: счет
реконструкция: реконструкция
служить: служит служить служили служило
появление: появление появлением появления
отмечено: отмечено
шутка: шуткой
помешать: помешало
протяжение: протяжении
амия: амия
реальный: реальных
ближайший: ближайшем
александр: александр
расположение: расположение
легочным: легочным
заметить: заметили заметить
водоемы: водоемы
тканная: тканная
смысл: смысла
вспомнить: вспомнить
никто: никто
пузырем: пузырем
получить: получит получил получить получили
отбросить: отбросить
информация: информацию информации
найти: найти
независимый: независимо независимым независимый
сложнее: сложнее
кровеносный: кровеносной кровеносную
примитивный: примитивной примитивная примитивный примитивным
облегчая: облегчая
джулиан: джулиан
вдоль: вдоль
очередь: очереди очередь
подтверждение: подтверждений
розовый: розовым
английский: английский
вроде: вроде
целый: целом
указание: указание
петрович: петрович
бун: бун
пострашнее: пострашнее
живя: живя
большинство: большинстве большинства
гидродинамическим: гидродинамическим
отходить: отходят отходит
склонный: склонна
основанный: основана
лоскут: лоскут
слева: слева
внимание: внимание
вместо: вместо
показаться: показаться
воздух: воздуха воздухе воздух воздуху
миокард: миокардом миокард миокарда
эмбрион: эмбриона
связь: связь
обязанный: обязана
иной: иной иного иную
наблюдаться: наблюдается
тип: типом
гомологи: гомологи
трех: трех
помещен: помещен
потеря: потерю
странный: странную странного
коп: коп
подтвердить: подтвердила подтвердить
положение: положения положению положением положение
активность: активность активности
затруднять: затрудняет
исследовать: исследовали исследовать
гидродинамической: гидродинамической
черный: черный
линия: линия
теоретический: теоретической
фотография: фотография
обнаружить: обнаружить
предварительный: предварительными
работать: работают
название: название
непростой: непростые непростым
эктодермой: эктодермой
обратный: обратное
обыкновенный: обыкновенный
сечение: сечении
разность: разность
роль: роль роли
физиологическими: физиологическими
сквозь: сквозь
парижский: парижских парижская парижской
содержание: содержанием содержание содержания
способ: способе способ
перевести: перевести
ганоидов: ганоидов
редукция: редукции редукцией
количество: количество
разделить: разделить
специализация: специализация
интерпретация: интерпретацию
человек: людей человека человеку
сенсационный: сенсационными
пирсон: пирсон
сходный: сходная
палеонтология: палеонтология
клетка: клеток
пескоройки: пескоройки
примыкать: примыкает
желудочек: желудочка
аорта: аорту аорты аорте аорта
хитрый: хитрые
леонид: леонид
левый: левое левого левая
спешить: спешить
модифицировались: модифицировались
исходный: исходной исходно
немедленный: немедленно
тяжесть: тяжести
бронислава: бронислава
казаться: казалось
поднимаясь: поднимаясь
путь: пути
опираясь: опираясь
унаследовано: унаследовано
эллипсом: эллипсом
немецкий: немецкий
нестабильный: нестабильной
правый: правое правого правая
производный: производное
участок: участок
мясистолопастным: мясистолопастным
энтодермой: энтодермой
слово: словами
нерв: нервов
физиологически: физиологически
специализированные: специализированные
тихий: тихому
легкого: легкого
посмотреть: посмотрим
регуляторные: регуляторные
разбавляя: разбавляя
признав: признав
сценарий: сценарий сценария
возможный: возможным возможно
недоразвитый: недоразвитой
отдельный: отдельно
кстати: кстати
легочные: легочные
жабры: жабрами жабр жабры жабрах жабру
происходить: происходят происходила
ставить: ставят
друг: друг друга другу
обстоять: обстоит
несущий: несущая
черта: черты
настоящий: настоящие настоящего
архаичный: архаичные
вполне: вполне
благодаря: благодаря
прилегающий: прилегающие
местообитаниям: местообитаниям
процесс: процесс
больший: большие
переходный: переходных
лабиринтовые: лабиринтовые
вызывать: вызывает
половина: половиной
купелло: купелло
принятый: приняты
перри: перри
обозначено: обозначено
сантиметр: сантиметров сантиметра
река: реках
градус: градусов
неизменный: неизменно
предназначенный: предназначенный
принадлежать: принадлежат
ризодус: ризодус
обращать: обращают
перестать: перестала
экологический: экологическая
причина: причину причиной
челюстной: челюстной
смит: смит
двусторонне: двусторонне
выход: выходом
закрытопузырное: закрытопузырное
работа: работы работе
теория: теории
вошел: вошел
морфология: морфология
пошел: пошел
условие: условий условиям условиях
мозаика: мозаике
амфибии: амфибии
поперечный: поперечном поперечный
снизить: снизит
максимальный: максимально
история: истории
легкие: легкие
вентролатеральный: вентролатеральный
туловище: туловищу туловище
целакантам: целакантам
нескольких: нескольких
щука: щука щуки
порядок: порядке
сокращение: сокращение сокращения
создает: создает
выносящей: выносящей
увидеть: увидеть
множество: множество
разросшийся: разросшийся
удивительный: удивительно удивительный
зарываться: зарываются
древний: древнюю древней древний
зоология: зоология
девонский: девонских девонским
ранний: ранних ранняя
превышать: превышает
обсуждаемой: обсуждаемой
малочисленный: малочисленны
последний: последние последний последней последняя последнего
биолог: биолог биологам биологи
вестолл: вестолл
ткань: тканей тканям тканях
голова: голову голова
вывод: выводы вывод
размер: размере
лёгкий: легко легче
ветвление: ветвление
наблюдение: наблюдения
польза: польза
предположение: предположение
отдаленно: отдаленно
спинной: спинной спинную спинного спинная
майкл: майкл
одним: одним
вентролатеральные: вентролатеральные
обобщенной: обобщенной
шлиф: шлиф
перенос: перенос
кожный: кожное
постепенный: постепенным постепенно
семейство: семейству семейство
источник: источник
признак: признаки признаку признакам признаков
водный: водные водных
задействованных: задействованных
гомология: гомология
простой: простой простым простое
изменение: изменениями
снижение: снижении
ввел: ввел
редуцироваться: редуцировались
череп: черепа
сантиметровой: сантиметровой
мелькавшие: мелькавшие
открывающихся: открывающихся
идея: идея
наличие: наличия
задача: задачей
легкое: легкое
принять: приняли
протоптера: протоптера
шести: шести
насыщенный: насыщенная
учтем: учтем
легочными: легочными
вырост: выростов выростами выростом выроста выросты вырост
трубка: трубки трубку трубкой
пар: пары пара
отдел: отдел отделы
позволять: позволяет
наибольший: наибольшем
многоперу: многоперу
малахов: малахов
снабжаться: снабжается снабжаться снабжалось
род: родами род
рассмотреть: рассмотреть
плавучесть: плавучесть плавучести
общий: общего общие общих общая
надкишечное: надкишечное
природа: природе природа
постоянный: постоянно
эволюция: эволюции
убеждённый: убеждена
многопера: многопера
соединенный: соединенный
обозначать: обозначает
дина: дин дина
приносящие: приносящие
фармер: фармер
смита: смита
латимерия: латимерия
обладатель: обладателей обладателям обладатель обладателя обладателях
допустить: допустить
насыщаться: насыщается
течь: течь
непонятный: непонятно
крупный: крупные крупным крупное крупных
облик: облик
научный: научную
первый: первых
иметь: имеют имеет имела
потребность: потребность
разный: разному разных разные разное
большой: большой
слабый: слабый слабо
аппарат: аппарате
головной: головной
уровень: уровня уровне
выделенный: выделен
конфигурация: конфигурация
отряд: отряду отряд
касающиеся: касающиеся
сохранить: сохранить
ценный: ценны
храниться: хранился хранятся
век: века веке
дискуссия: дискуссия
бесчелюстных: бесчелюстных
бесхвостый: бесхвостых
костный: костных костные костными
венозный: венозная венозную венозной венозное
бесчелюстные: бесчелюстные
летний: летнюю летней
какой: какое каком каких какую
млекопитающий: млекопитающих млекопитающим
сигнальный: сигнальные
легочной: легочной
ток: тока
жировым: жировым
формалине: формалине
лепидосирен: лепидосирен
сформировалось: сформировалось
осетрообразных: осетрообразных
водоемов: водоемов
дыхательный: дыхательную дыхательные дыхательный дыхательной дыхательная
помогать: помогает помогают
обстановка: обстановка
необычайный: необычайно
вода: воде воды воду
брюхо: брюху
лопастеперые: лопастеперые
слепой: слепо
выступать: выступал
версия: версию версия
желудок: желудок
эмбриологических: эмбриологических
исследовательница: исследовательница
море: море
масло: масла масло
хрящевых: хрящевых
вентромедиальное: вентромедиальное
ламбертц: ламбертц
судя: судя
являться: является являются
следовать: следует следовало
подтверждать: подтверждает подтверждают
набор: набору
неактивная: неактивная
форма: формы формой
указывать: указывает указывают
дорсолатеральный: дорсолатеральный
активный: активная активно
маркус: маркус
томографическая: томографическая
начальный: начальных
глотка: глотки глотке глотка глоткой
развиться: развились развился
гипотеза: гипотезу гипотеза гипотезы гипотезе
зародыш: зародыша
подъязычный: подъязычной
ясность: ясности
каменный: каменных
парный: парные парных парный парное
ген: генов гены
проблема: проблеме проблема проблемы проблему проблем
расположенный: расположены расположенный расположенную
мозг: мозг мозга
латимерию: латимерию
пойманную: пойманную
ствол: ствола
исключение: исключением
родство: родство
серия: серии серию
изначальный: изначально
отсутствовать: отсутствуют
сулавеси: сулавеси
угодный: угодно
измениться: изменилась
сверху: сверху
заготовка: заготовки
кислород: кислорода кислород кислородом кислороде
чешуя: чешуй
констатировать: констатировать
щель: щелями щель
выносящие: выносящие
вена: венами вене вена
леонард: леонард
легочных: легочных
пользоваться: пользуются
происходящие: происходящие
респираторный: респираторного респираторный респираторная респираторной респираторных
этап: этапов
рочека: рочека
знаменитый: знаменитом
рентген: рентгеном
правда: правда
связано: связано
капилляр: капилляры капилляров
результат: результате
остается: остается
фактически: фактически
охрана: охраной
одна: одна
логичный: логично
мышечный: мышечной мышечный мышечных
закладка: закладка
отличаться: отличаются
дуга: дугами дугой дуг дуги дугу дугам
сердце: сердце сердца
малан: малан
шарик: шарики
выпадать: выпадает
коллега: коллегами коллеги коллега
превратиться: превратилась превратился превратилось
уверенный: уверена уверены
значение: значение
снабжение: снабжения снабжение
донасытить: донасытить
сразу: сразу
выясниться: выяснилось
сообщение: сообщение
прорываться: прорываться
гомологичны: гомологичны
рыбий: рыбьей
вытянутый: вытянутый
обсуждая: обсуждая
связывающий: связывающий
пятилучевая: пятилучевая
существенный: существенной
рыбина: рыбины
компьютерный: компьютерной
ястреб: ястребов
считаться: считалось
диафрагма: диафрагмой
грань: грань
закладываются: закладываются
перикардно: перикардно
распадаться: распадается
открытый: открыты открытым
исследование: исследования исследованиям исследование
схема: схема
бак: бак
джеймс: джеймс
непарности: непарности
неясный: неясным
быстрый: быстро
учебный: учебного
пространственный: пространственное
оболочка: оболочка оболочки
пузырь: пузырь пузыря пузырей пузыре
рудиментарный: рудиментарное рудиментарны рудиментарный
суша: сушу
корректный: корректно
прохождение: прохождении
путать: путали
вопрос: вопрос вопросу вопросы вопроса вопросом вопросе
орган: органы орган органах органом органов органам органа органе
истый: ист
целаканты: целаканты
жаловаться: жаловаться
амфибий: амфибий
ряд: ряд ряда
поэтому: поэтому
приходиться: приходится
министр: министр
чрезвычайный: чрезвычайно
направление: направление
описать: описали
поддерживается: поддерживается
метод: методом
счете: счете
обозначение: обозначения
выигрыш: выигрыш
малый: малом
заполняющей: заполняющей
заплатить: заплатить
даниэль: даниэль
открытие: открытие
знать: знаем знал знать
эффект: эффектов эффектом
отказ: отказ
плавать: плавать плавали
масштабный: масштабного
контур: контур
непрерывность: непрерывности
низкий: низким низкое
рогозуб: рогозуб
задний: задней задняя заднего задних
мышь: мыши
иллюстрация: иллюстрация
развитие: развития развитием развитии развитие
ихтиолог: ихтиолог
сделанная: сделанная
сохраняться: сохраняется
толкование: толкования
барий: бария
немногий: немногих
некоторые: некоторых некоторые некоторыми
триггером: триггером
наружу: наружу
подкишечного: подкишечного
стрелок: стрелки стрелками
резкий: резкие
пробел: пробелы
легочная: легочная
австралийский: австралийский австралийской
являющихся: являющихся
древо: древа
распространенный: распространенный
викторович: викторович
термин: термин
пояснение: пояснения
продолжением: продолжением
высокий: выше
поглощать: поглощать
срочный: срочного
богатый: богатая
эволюционный: эволюционное эволюционных эволюционную эволюционного эволюционный эволюционной эволюционном
естественный: естественно естественной
давать: дают
различный: различна
состоять: состоит
требовательного: требовательного
обведено: обведено
позвоночный: позвоночных позвоночные
сирена: сирен сирены
энтодермальное: энтодермальное
способствовать: способствует
рептилия: рептилий
функциональный: функциональный
профессор: профессор
экспрессия: экспрессии экспрессия
вперед: вперед
пусть: пусть
интерпретировать: интерпретировать
животное: животных животного животное животном
представленный: представленных представлен
период: периода
кровообращение: кровообращения
среда: среда
выносящую: выносящую
рыбак: рыбаки
назовет: назовет
передний: передней передний передних передние
исключена: исключена
возникать: возникали возникать возникает возникают
продвинутый: продвинутый
заполненного: заполненного
исходя: исходя
древние: древние древним древних
дорсальный: дорсальный
знание: знаниях
литература: литературе
место: место
курс: курса
южноафриканский: южноафриканский
самка: самку
крайний: крайне
латимерии: латимерии
эмбриологической: эмбриологической
плавник: плавников
понять: понять
сергей: сергей
закрываться: закрывается
вводя: вводя
удалось: удалось
соответственный: соответственно
ошибка: ошибкой
внешний: внешне внешним внешняя внешних внешней
факт: фактов факт факты
ниельсен: ниельсен
переходить: переходить переходит
стать: стали стало стала
лучеперой: лучеперой
выделить: выделил
премьер: премьер
накопление: накоплению
такой: таким таких такого таком такую
система: системы система системе систему
обозначены: обозначены
лондон: лондона
вещество: вещество вещества
существовавшего: существовавшего
ботриолеписа: ботриолеписа
подавляющий: подавляющего
прийтись: пришлось
наших: наших
зависеть: зависит
тёмный: темно
непарность: непарность
оказывать: оказывает
разница: разница
взгляд: взгляд
капля: капли
легочное: легочное
спросить: спросил
плотный: плотные
редкость: редкость
парадоксальный: парадоксальный
счёт: счета
произошел: произошел
нашем: нашем
ухудшить: ухудшило
насчет: насчет
лишен: лишен
единственный: единственным единственный единственной
получившая: получившая
прошедший: прошедшую
специализированный: специализированный
водиться: водится
сильный: сильно сильнее
интересный: интересно
смешивание: смешивания смешивание
число: числа числе
сопровожденные: сопровожденные
затвердевшие: затвердевшие
ответ: ответа ответ ответов
латинский: латинское
дорсомедиальный: дорсомедиальный
собираться: собирается
приспособление: приспособление приспособления
возможность: возможность
окружено: окружено
сместиться: сместилось
решающий: решающим
владимир: владимир
типичный: типичного типичными типичная
птица: птицам птиц
итак: итак
аэрированной: аэрированной
выловить: выловили
функция: функцию функция функции функций
артерия: артерии артерия артериям артериями артерий
пересыхать: пересыхают
отражать: отражает
считать: считать считает
миграция: миграции миграция
небольшой: небольшого
опубликовать: опубликовал
пример: примеров примеру пример
реализоваться: реализуются
доживших: доживших
коморская: коморская
назвать: назвать
предок: предки предков предка предкам предками
точный: точно
ним: ним
вероятный: вероятно
абсолютный: абсолютно
жир: жира жир жиром
камбала: камбалы
основание: основания основании
плохой: хуже
амниот: амниот
день: дня дней
метр: метров
листок: листком
оставлять: оставляют
точка: точки
васильев: васильев
осмотрев: осмотрев
сторона: стороны сторону сторон стороне
генный: генная
прямой: прямо
синить: синим
жировое: жировое
многоперообразных: многоперообразных
происхождение: происхождение происхождения происхождению
британский: британские
получать: получать получает
наземный: наземных наземные
газовый: газовое
принцип: принципе
проходить: проходит
покидать: покидать
обеспечивая: обеспечивая
образ: образом
управлять: управляет
лепидосирена: лепидосирена
древнейший: древнейших
добавить: добавить
длина: длина длиной
данио: данио
васнецова: васнецова
ценность: ценность
видимый: видим видимо
выползать: выползают
учебник: учебники
полагаться: полагаться
боковых: боковых
последовательный: последовательные последовательно
остров: островов
взрослый: взрослой взрослого взрослых
имеющийся: имеющихся
вообще: вообще
колин: колин
полученным: полученным
уникальный: уникальны уникальная уникальных
жизнь: жизни
нарисована: нарисована
звездочка: звездочка
инъекция: инъекции
помимо: помимо
несет: несет
вместе: вместе
разделена: разделена
легком: легком
тщательный: тщательное тщательно
допускать: допускают
мясистолопастных: мясистолопастных
лучеперые: лучеперые
брызгальце: брызгальце
многочисленный: многочисленным
сонный: сонные
четко: четко
печень: печень
дно: дно
подниматься: поднималась
намного: намного
непарный: непарное непарный непарным непарного непарную непарные непарной непарная
относительный: относительно
действие: действие
применяя: применяя
контрастный: контрастное контрастного
делать: делает делают делали
юрского: юрского
лучеперых: лучеперых
масса: масса массу
фича: фича
ныне: ныне
коморских: коморских
относиться: относятся относится
самый: самую самая самый самых
двоякодышащая: двоякодышащая
позволяя: позволяя
просвет: просвет просвете
актинистии: актинистии
огромный: огромная
транскриптомов: транскриптомов
дорсолатеральные: дорсолатеральные
судьба: судьба
околосердечную: околосердечную
нести: несут
план: планом
макропомы: макропомы
воздушный: воздушным воздушного воздушное воздушном
частота: частота
частить: части
пригодиться: пригодится
появляться: появляется
газообмен: газообмена
особенность: особенность
эффективнее: эффективнее
жан: жан
данный: данного
таки: таки
энтодермальные: энтодермальные
плавающих: плавающих
аргумент: аргументом
всякий: всякий
остаться: останется
проигрыш: проигрыш
консервирующей: консервирующей
существовать: существует
увеличение: увеличения увеличение
сохранившие: сохранившие
позволить: позволило
книга: книги книгу
вторичный: вторичной вторичного вторичное вторична
означать: означать означает
идти: идти
мускульный: мускульного
индонезийский: индонезийская
сходиться: сходится
картинка: картинка картинку
широкий: широко
поворот: поворот повороты повороте
отметить: отметим
мышца: мышц мышцы
губчатый: губчатый
липидами: липидами
пищевод: пищевода пищевод пищеводом
случай: случаев случае случаях
идет: идет
мнение: мнению
остальное: остальные остального остальное
атрофированы: атрофированы
встречать: встречал
некогда: некогда
русский: русский
глотнуть: глотнуть
экземпляр: экземпляров экземпляра
живородящий: живородящая
музей: музее
разнообразнее: разнообразнее
встречающимся: встречающимся
утверждение: утверждениям
подобный: подобные подобного подобных
таксон: таксон
желтым: желтым
думать: думали
задаться: зададимся
одно: одно
проявлять: проявляют проявляет
лишив: лишив
симметричных: симметричных
момент: момент
который: которое которым которую
образованный: образован
змееголовы: змееголовы
одну: одну
мочь: могли могло
существо: существа
баг: баг
свой: своему
дыхание: дыхания дыханием дыхание дыхании
многие: многие многих
африка: африке
выполняющих: выполняющих
налицо: налицо
изобретение: изобретения
упоминаться: упоминалось
легких: легких
напряженной: напряженной
рассмотрение: рассмотрении
смешанный: смешанную
смутиться: смутился
башфорд: башфорд
специальный: специальных специальными
подключить: подключить подключили
галеаспид: галеаспид
строение: строению строении
развеивать: развеивают
заодно: заодно
кишечный: кишечной кишечную
мясистолопастные: мясистолопастные
поменять: поменять
характер: характеру
рамка: рамкой
остроумный: остроумное
склоняться: склоняется
взята: взята
волнистый: волнистая
содержащий: содержащий содержащую
продолжаться: продолжаются
предсердие: предсердии
изучить: изучили изучить
любой: любое любом любые
легким: легким
классический: классическая классической
васнецов: васнецов
настроенный: настроенной
легочном: легочном
заставить: заставить
однозначный: однозначно
объединить: объединить
филогенетика: филогенетика
анатомия: анатомии анатомию
впадать: впадают впадает
живет: живет
возникновение: возникновение возникновения
александровича: александровича
запасной: запасного
особый: особое особая
томографии: томографии
цвет: цветом цвет
личинка: личинки личинка
правильный: правильный
агассис: агассис
играть: играет
пятилучевой: пятилучевой
приносящей: приносящей
начинаться: начинаются
суженной: суженной
рентгеновский: рентгеновской
стрелочка: стрелочки
змея: змей
произойти: произошли произошло
уменьшиться: уменьшилась
отверстие: отверстие отверстия
соответствовать: соответствуют
физиология: физиология физиологии
эксперимент: экспериментами эксперименты
нагрузка: нагрузка
утратившее: утратившее
очевидный: очевидных очевидно
палеонтолог: палеонтологи палеонтологам палеонтологами
рассматривать: рассматривает
неработоспособный: неработоспособной
белый: белый
прийти: пришла пришло
перегородка: перегородки перегородка
экскурсия: экскурсий
скорый: скорее
просвечивать: просвечивали
томас: томас
акула: акул
