спугнутая: спугнутая
ускользнувшая: ускользнувшая
установленный: установленным
исключено: исключено
длинноусой: длинноусой
касаться: касается
отсутствовать: отсутствуют
находить: находить находит
камень: камнями камнях камень
недостаточный: недостаточно
сбор: сбора сбор
остальное: остальных
приемлемый: приемлемой
сразу: сразу
интересоваться: интересуется
удирать: удирает
журнал: журнале
склонный: склонны
выигрывать: выигрывают
справа: справа
инициатор: инициатор инициаторов
небольшой: небольших
заякоривание: заякоривание
донный: донного
набор: наборы
оставаться: оставался
двигаться: движется
снижаться: снижается
переходить: переходить
полагать: полагали
эйлат: эйлат
радужный: радужная
регуляция: регуляции
управлять: управлять
учитывая: учитывая
ловкий: ловко
возможный: возможно
эксплуатация: эксплуатация
различаться: различаются
редкий: реже редко
видео: видео
выгонять: выгонять
выгодный: выгодно выгодна
потенциальный: потенциальных
перемещаться: перемещается
горизонтальный: горизонтальной
искусственный: искусственную
разный: разные разных
периодически: периодически
открывать: открывает
фактор: фактор
степень: степень
специалист: специалисты
единовластный: единовластным
подвижнее: подвижнее
менять: меняет
опыт: опыта
вместе: вместе
гибкий: гибкая
слабый: слабо
часы: часов
рассматриваться: рассматриваются
определенный: определенный
разнообразный: разнообразных
пребывание: пребывание
сопоставление: сопоставлении
убежище: убежищ
уровень: уровню
подтвердить: подтвердили
случай: случае случаев
отрицательный: отрицательной
чистильщик: чистильщиками
засадный: засадный засадные
растягиваться: растягиваются
исследовать: исследует исследуют
высокий: высокую
понять: понять
настоящий: настоящее
коллектив: коллективов коллектива
отражающие: отражающие
командир: командиром
играть: играет
груперам: груперам
прерывистый: прерывисто
мурены: мурены
помощник: помощников
агрессор: агрессор
сильный: сильнее
орган: органы
растет: растет
умеющими: умеющими
одиночка: одиночку
рис: рис
межвидовые: межвидовые
показывать: показывает
слева: слева
спустя: спустя
морской: морских морском
частота: частоте частота частотой
наличие: наличии наличие
интенсивность: интенсивности
становиться: становится становятся
подвижность: подвижности подвижностью
конспецификами: конспецификами
отношение: отношений отношению отношения отношениям
вытекающее: вытекающее
охотящегося: охотящегося
успешный: успешного успешных успешно
лидерский: лидерские
средний: средняя
заснять: заснять
влиять: влияло влияет
новый: новую новое
первый: первом первых
иной: иными
участник: участниками участники участников
сила: сил
животное: животном животными животного животных животным
препятствие: препятствием
изученным: изученным
влияние: влияния влияние
чужой: чужие
моллюск: моллюсков
открытый: открытым
золотистый: золотистая золотистой
осуществленных: осуществленных
устроены: устроены
партнера: партнера
нахлебничеству: нахлебничеству
стратегия: стратегий
лидер: лидерами
главное: главных главные
посвящена: посвящена
естественный: естественной
односторонний: односторонняя
иметь: имеют имеет
длинноусая: длинноусая
толстый: толще
инициируют: инициируют
обследовать: обследует
эволюция: эволюции эволюция
груперы: груперы
совершенный: совершенно
статья: статье статья статьи
шум: шума
зачинщик: зачинщики
вопрос: вопрос вопросу
пинать: пинает пинают
смысл: смысле
подтверждаться: подтверждается
пространство: пространство
раздражать: раздражает
путь: пути
побуждая: побуждая
объект: объектом
пользоваться: пользуются
эпизод: эпизодов
инициировать: инициировать
другой: другом другого другому
получать: получают
итог: итоге
выполнять: выполняют
спрятавшейся: спрятавшейся
жертва: жертв
влиятельный: влиятельным
партнерами: партнерами
свой: своими
влиятельность: влиятельность
скрываться: скрываться
существовать: существует
ищущий: ищущих
толчок: толчков толчки
осьминог: осьминога осьминогов осьминог осьминогу осьминогом осьминоги
столь: столь
возвращаться: возвращается возвращаться
переход: переходов
извлечение: извлечения
помогающие: помогающие
распределяться: распределяются
удаляться: удаляться
авторитетный: авторитетная
заякориваний: заякориваний
эффективный: эффективных эффективного
хищный: хищных хищные
сигнал: сигнала
принцип: принципе
руководитель: руководитель
средство: средством средство
ведет: ведет
сложный: сложная сложных сложные
обнаружено: обнаружено
подплывет: подплывет
перемещение: перемещений перемещение перемещения перемещениями
назвать: назвать
невелика: невелика
спектр: спектр
считаться: считаются считается
рисунок: рисунок
плавник: плавники
резкий: резко
смочь: смогли
придерживаться: придерживаются
попытка: попыток
одном: одном
атакованы: атакованы
прилагающегося: прилагающегося
качество: качестве качества
вода: воды
перепонка: перепонки
белая: белыми
зависеть: зависят
зрение: зрения
млн: млн
система: система системе
указывая: указывая
опция: опций опции
лентяй: лентяев
член: члена членом члены членов член
компетентность: компетентность
расщелина: расщелин
успешность: успешности успешность
эксплуатируя: эксплуатируя
станция: станции
налаживание: налаживания
центроида: центроида
выявляться: выявляются
безоговорочный: безоговорочно
важный: важную
примерно: примерно
способность: способности способностей
выстроить: выстроила
низкий: низкая
дельфин: дельфины
достает: достает
скрупулезный: скрупулезный
присутствие: присутствии
съедобный: съедобный съедобное съедобного
выясниться: выяснилось
поступок: поступки
уступать: уступают
гибкость: гибкости
израиль: израиль
энергичный: энергичные энергичных
усилие: усилия усилий
вариант: варианта
случайный: случайного
разделение: разделение разделении
эксперимент: эксперименты
звать: зовут
свита: свита
сторона: стороны
общий: общее общей общий
удивительный: удивительно
связана: связана
полученных: полученных
механизм: механизм
эффективность: эффективности эффективность
уникальный: уникальной
жила: жил
тратить: тратить
середина: середине
объяснять: объясняет
исследовательский: исследовательское
спрятавшуюся: спрятавшуюся
морфология: морфология
методика: методика
последовать: последовал
атаковать: атакует
одиночный: одиночным
информативны: информативны
наверное: наверное
идея: идеей идее
делать: делает
заякоривания: заякоривания
главный: главный
какой: каких какими какую какое
польза: польза пользы
осень: осенью
краснополосый: краснополосый
инициирует: инициирует
роль: роли роль
количество: количеству количеством
групера: групера
доминантный: доминантный
отсутствие: отсутствие
проявлять: проявляют проявляет
сидеть: сидеть
каждый: каждого
начинать: начинает
ловить: ловить
показать: показали
поэтому: поэтому
разведчик: разведчиков разведчики
например: например
порождающих: порождающих
неподвижный: неподвижно
агрессивный: агрессивных агрессивные
интерпретировать: интерпретировать
достается: достается
возможность: возможности
оказаться: оказаться оказался оказалось
дайвинга: дайвинга
предпочитающий: предпочитающий
съесть: съел
обстановка: обстановке
наблюдение: наблюдения
отталкивая: отталкивая
охота: охота охотой охоту охоты охот охотах охоте
второй: втором вторых
инициация: инициация
никто: никто
образ: образом
партнеров: партнеров
втрое: втрое
изучено: изучено
некоторые: некоторые некоторых
разобраться: разобраться
наибольший: наибольшее
корреляция: корреляцией
товарищ: товарищей
вариола: вариола
ограничивающий: ограничивающий
влиятельности: влиятельности
интерес: интересов
противодействие: противодействия
редкость: редкость
краснополосые: краснополосые
рельеф: рельефа
выбор: выбора
большинство: большинстве большинство
краснополосых: краснополосых
определить: определить
александр: александр
толкать: толкают толкает
ним: ним
совокупность: совокупности
кадр: кадр
искать: ищут искать
полный: полными полные
предоставлять: предоставляют
радикальный: радикально
основа: основе
идентификация: идентификация
дополнительный: дополнительные
друг: друг друга
такой: таких такого таким
меняться: меняется
шевелиться: шевелиться
больший: большая
море: море
который: которому которую которое
заякориванию: заякориванию
сказываться: сказывается
занимать: занимает
явление: явление
относительный: относительно
объясняться: объясняются
поисковый: поисков
начиная: начиная
данный: данном
опубликованная: опубликованная
поближе: поближе
размещавшимися: размещавшимися
асоциальность: асоциальность
обследование: обследования
целый: целом целая
сопровождать: сопровождает сопровождают
барабули: барабули
решить: решил
полезный: полезного
обсуждаемой: обсуждаемой
вкладывать: вкладывать
обоим: обоим
функция: функций функцию
чуждый: чужды
видимый: видимому видим
кормушка: кормушками кормушки кормушках кормушку
увидеть: увидеть
добраться: добрались
оси: оси
натягиваться: натягивается
предложенных: предложенных
увлечь: увлечь
опережать: опережают
тыркают: тыркают
секунда: секунды
одинаковый: одинаковой
наводя: наводя
взаимодействие: взаимодействий взаимодействиях взаимодействия
преследовать: преследует
движение: движения движение движений
оставлять: оставляет
отлынивать: отлынивают
клиент: клиентами
инородец: инородцами
равный: равных
выяснить: выяснить
эгоистический: эгоистических
пошарить: пошарить
коллективный: коллективных коллективной коллективного
краснополосого: краснополосого
никакой: никакой
помочь: помог
сложность: сложности
максимальный: максимальна
вес: вес
позиция: позицию
оттопырив: оттопырив
непреодолимый: непреодолимым
рыба: рыб рыбы рыбам рыбу рыбами
представленный: представлены
место: месте место мест места
выделить: выделили
пинок: пинков пинками
германский: германских
суетливый: суетливы
заякоривателей: заякоривателей
подтверждать: подтверждают
марков: марков
нескольких: нескольких
пытаться: пытаются
бесспорный: бесспорно
олушам: олушам
удается: удается
очистка: очистки
должный: должны
широкий: широкий
интересный: интересным интереснее
груперов: груперов
раздаваемых: раздаваемых
пассивность: пассивность
краснополосым: краснополосым
яркий: ярко
дело: дело
остается: остается
охотящиеся: охотящиеся
оказывать: оказывают
высший: высшую
фактически: фактически
раз: раза
миро: мире
ход: ходе
синий: синяя синие синих
подвижный: подвижные подвижной
поскольку: поскольку
сводиться: сводятся
самый: самая самым самый
обнаруживая: обнаруживая
закономерность: закономерности
коралл: коралл
точка: точку точки
спрятаться: спряталась
строгий: строгий
охотничий: охотничьих охотничьи охотничье
поиск: поиски поиске
элемент: элементы
взаимоотношение: взаимоотношения
биолог: биологов
охотясь: охотясь
выгнать: выгнать
сотрудничать: сотрудничать
помогать: помогают
лишний: лишних
стоять: стоит
инстинкт: инстинктов
вертикальный: вертикальной
характерный: характерным
пример: пример примере
добыча: добычу добыча добычи
вид: видов виды вид
наблюдать: наблюдали
данные: данных
видный: видно
рыбка: рыбок
португальский: португальских
помогающих: помогающих
вьющийся: вьющиеся
меря: мере
необычный: необычных
укрытие: укрытий укрытия
межвидовой: межвидовой
постройка: постройках
часть: часть
щупальце: щупальцами щупальцем
партнерам: партнерам
основанный: основанной основанная
красный: красном
дно: дне
усатый: усатые
регулировать: регулирует
чувство: чувств
сложнее: сложнее
слово: словами
начать: начать
вступать: вступать
приходиться: приходится
коралловый: коралловых
трех: трех
одна: одна
компаньон: компаньона компаньон компаньонам
следовать: следует следуют
эксплуатировать: эксплуатируют
ситуация: ситуация ситуации
показатель: показатели показателей
доля: доля
натягивание: натягиваний
совместный: совместная совместной совместных
лежать: лежат
количественный: количественный количественные
факт: фактом
природный: природная
избежать: избежать
предок: предок
навык: навыков
трещина: трещинах
выбрать: выбрать
кооперация: кооперации
выискивающие: выискивающие
барабуль: барабуль
социальный: социальными социальную социально социальным социальных
тип: типа
заякорить: заякорить
оказываться: оказываются
труднодоступный: труднодоступных
найти: найти
хищник: хищников хищники хищник
выработать: выработали
удалось: удалось
острый: остро
пояснить: пояснить
недюжинный: недюжинную
кооперативный: кооперативных кооперативные
групер: групер
иерархия: иерархия иерархии
пустой: пустыми пустые
уходить: уходит
продолжительность: продолжительностью продолжительности продолжительность
попарном: попарном
проводиться: проводились
активный: активно активнее
являться: являются является
мурен: мурен
доминирование: доминирования
очевидный: очевидна очевидно
переместиться: переместиться
позади: позади
предлагаемых: предлагаемых
сардина: сардин
полевой: полевые
попадающиеся: попадающиеся
увеличиваться: увеличивается
анализ: анализа анализ анализе
отдельный: отдельных
плыть: плыть
служить: служат
вывод: вывод
уметь: умеют умеет
основный: основных
барабулей: барабулей
центр: центра
род: рода
соответствующий: соответствующих
толчется: толчется
знать: знаем
еда: еда
согласоваться: согласуется
взаимовыгодный: взаимовыгодных взаимовыгодное
представитель: представителями
исследование: исследований
барабуля: барабуля
подсказывать: подсказывать
сотрудничество: сотрудничество сотрудничества
ученые: ученые
особь: особей особь особи особями
нечастый: нечасто
гораздо: гораздо
глубина: глубине
поведение: поведение поведения поведении
заключительный: заключительная
позволять: позволяет
группа: группе группы группа
решать: решает
источник: источник
ракообразный: ракообразных
увлечение: увлечение увлечения увлечений
наводка: наводке
