земля: земли землю
стать: стать
прецессии: прецессии
достаточный: достаточно
идея: идее
переплавка: переплавка переплавки
сидерофильных: сидерофильных
помощь: помощью
минерал: минерал
гравитационный: гравитационно гравитационной
тепловая: тепловая
спутник: спутника спутник спутниками спутнике
являться: является являются
становиться: становится
условие: условиях
луна: луны луна луной
объяснение: объяснение
большинство: большинстве
следующий: следующим
новость: новость
геохронологии: геохронологии
согласоваться: согласуется
примерно: примерно
доставленные: доставленные
удаление: удаления удалении
давать: давал дают
приливный: приливный приливного приливным
подниматься: поднимается
должный: должен
опубликованного: опубликованного
мантия: мантии мантий мантию
элемент: элементов элементы
циркона: циркона
произойти: произошло произошла
возможный: возможно возможное
рассчитать: рассчитали
происхождение: происхождения происхождении
расслоение: расслоение
аполлон: аполлон
относящиеся: относящиеся
вызванный: вызванного
слоев: слоев
быстрый: быстро
большой: большом
динамический: динамическими динамических
вещество: вещества
тейя: тейя
группа: группы
вулканизм: вулканизм
переплавились: переплавились
представлять: представляют
южный: южный
возраст: возраст возраста
силикатных: силикатных
проходить: проходить
десяток: десятков
импактная: импактная
металл: металлов
соответствие: соответствии
дифференциация: дифференциация дифференциации
тейи: тейи
привести: привела привело
молодой: молодой
ясный: ясно
лапласа: лапласа
единый: единой
модуль: модуль
стрекопытов: стрекопытов
ряд: ряд
принятый: принятого
связанный: связанный связанного связан
загадка: загадок загадку
возникнуть: возникла возникнуть
автор: авторами авторы авторов
численный: численного
интенсивность: интенсивность
калий: калия
сходный: сходной
значение: значение значениями
обусловленный: обусловленным
показать: показали
течение: течение
поверхность: поверхность поверхности
эпизод: эпизода
столкновения: столкновения
прохождение: прохождением
кобальт: кобальта
эксцентриситета: эксцентриситета
вызвать: вызвать
одна: одна
древние: древние древним
равный: равным
находиться: находилась находится находились находиться
возникшее: возникшее
теплового: теплового
располагаться: располагался
сотня: сотен
рисунок: рисунок
сброс: сбросу
гипотеза: гипотеза гипотез
ромб: ромбами
остаться: остались
удар: ударов
тотальное: тотальное
сценарий: сценарий
скорость: скорости
зерно: зерна
история: истории история
равновесие: равновесии равновесия
цирконы: цирконы
грунт: грунт
порода: породы пород породах
фосфор: фосфора
достижение: достижение
конец: конца
частить: части
сформировались: сформировались
имевшее: имевшее
исчезнуть: исчезли
мнение: мнению
переплавление: переплавление
закрытие: закрытие
исходить: исходят
бассейн: бассейне
трех: трех
радиоизотопного: радиоизотопного
первичный: первичного первичной первичная
обособление: обособлением
космический: космической
кристаллизация: кристаллизации кристаллизация
ганимедом: ганимедом
объяснить: объяснить
переплавлению: переплавлению
космос: космос
кассини: кассини
моделирование: моделирования
эволюция: эволюцией эволюции
анортозитовая: анортозитовая
слой: слой
полученной: полученной
неоднородность: неоднородность
охватывающего: охватывающего
объесть: объем
граница: границ
цикл: циклов
трактовка: трактовка
никель: никеля
сайт: сайта
расплавленный: расплавленный
китайский: китайской
объяснять: объясняет
ранний: ранней раннему ранняя ранних
орбитальный: орбитального
эвекционным: эвекционным
центр: центре
исследование: исследования
гигантский: гигантского гигантское
германий: германии
расплавленную: расплавленную
подвергаться: подвергалась
франция: франции
показывать: показывают
появление: появление
датирования: датирования
плавление: плавления плавление
рамка: рамках
переплавлялась: переплавлялась
сохраниться: сохранились
поток: потока поток потоке
горизонтальный: горизонтальном
данные: данными данные
программа: программы
активность: активности
привел: привел
кора: коры кора
геологический: геологической геологическая
учеными: учеными
предположительно: предположительно
предполагаемый: предполагаемой
пройти: пройти
образовавшегося: образовавшегося
образование: образования образованию образование
совпадать: совпадает
сбрасываться: сбрасывался
адвекции: адвекции
образец: образцов образцы
сохранившиеся: сохранившиеся
изохроны: изохроны
например: например
рассеиваться: рассеивается
погрузиться: погрузились
указывать: указывает указывают
геохимический: геохимическую
обнаруженные: обнаруженные
такой: такого
смешение: смешения смешении
предложенная: предложенная
материал: материала
предложенный: предложенный
крупный: крупные
оценивать: оценивают
тело: тел тела
значительный: значительно
повторный: повторному
новый: новая нового новой
хронология: хронологии
считать: считают
кратер: кратеров кратере
образ: образом
крупномасштабный: крупномасштабной
рис: рис
формирование: формирования формированию
система: системы системе
уран: уран
море: морей моря
вследствие: вследствие
плоскость: плоскости плоскость
тепловой: тепловой
реальный: реального
ядро: ядра ядре
происходить: происходит происходила
событие: события
циркон: циркон
переплавления: переплавления
основный: основных
полюс: полюс
бомбардировка: бомбардировки бомбардировке
метод: методов методом
оценка: оценка
тугоплавкие: тугоплавкие
одинаковый: одинаковым
период: период периоды периодом
гипотетический: гипотетической
другой: другими другого
магма: магма
статья: статья статьи
ускорение: ускорения
одному: одному
мощнейший: мощнейший
дробиться: дробится
цирконов: цирконов
второй: втором
юпитер: юпитера
первый: первом
направление: направлении
ответ: ответ
собрать: собрал
составлять: составляет
опубликованы: опубликованы
испытать: испытала
столкновение: столкновение
сатурна: сатурна
энцеладе: энцеладе
прежде: прежде
отмечать: отмечают
прецессию: прецессию
расчетам: расчетам
тепловом: тепловом
происходящие: происходящие
позволять: позволяет
эффект: эффекты
расслоенного: расслоенного
разноглубинных: разноглубинных
планетный: планетного
дать: дадут
сша: сша
наличие: наличие
производная: производные производными
недрах: недрах
пример: примером
вращения: вращения
радиоизотопной: радиоизотопной
перигей: перигея
число: число
слились: слились
вдоль: вдоль
рециклинга: рециклинга
название: название
меньший: меньшей меньшее
мочь: могла могло могли
магматический: магматического
исходя: исходя
застывание: застывание
парадокс: парадоксы
швейцария: швейцарии
планетезималями: планетезималями
планета: планетой планет планеты
обсуждаемой: обсуждаемой
особенность: особенности
анализировались: анализировались
повышенный: повышенный повышенному
тяжелых: тяжелых
окончательный: окончательное
согласный: согласно
редкоземельных: редкоземельных
расплава: расплава
вулканический: вулканической
кристаллизоваться: кристаллизовались
вытянутый: вытянутая
млн: млн
художник: художника
сравняться: сравнялись
нескольких: нескольких
относительный: относительно
частичный: частичному
подтверждать: подтверждают
расплавленной: расплавленной
благодаря: благодаря
астрономических: астрономических
изотопный: изотопного изотопный изотопные изотопном изотопным
сформировалась: сформировалась
возникать: возникает
данный: данного
результат: результаты результате результатами
путем: путем
солнечный: солнечной
галилеевыми: галилеевыми
сравнение: сравнения сравнению
базальт: базальтах
древнейший: древнейших
причина: причиной
блок: блоки
состав: состава состав
распад: распада
изучать: изучали
млрд: млрд
который: которое которыми
земной: земной
резонанс: резонанса резонансом
высокий: выше
полученными: полученными
разброс: разброс
застывший: застывшая
вывод: вывод
третий: третьем
ферроанортозитах: ферроанортозитах
содержание: содержанию содержание
предполагать: предполагают
представление: представлении
модель: модель моделями моделей
целый: целом
расчетным: расчетным
количество: количеством
широкий: широкий
проведенного: проведенного
популярный: популярных
миссия: миссией
поздний: позднее поздних поздними
опубликована: опубликована
процесс: процесс
отсутствие: отсутствие
отношение: отношениям
собранный: собранных
среди: среди
яркий: ярким
соотношение: соотношению
горный: горные
разогрев: разогрев разогрева
цирконах: цирконах
размер: размерам
отклонение: отклонением
случай: случае
выделение: выделение
образоваться: образуется
исследователь: исследователи
подповерхностных: подповерхностных
современный: современный
источник: источников источники
анортозитового: анортозитового
твердой: твердой
энергия: энергия энергии
диапазон: диапазоне
меря: мере
радиус: радиусов
верхний: верхней
скапливаться: скапливаются
посадочный: посадочный
расстояние: расстоянии
свинцовый: свинцовым
выглядеть: выглядела выглядит
предлагать: предлагают
приблизительный: приблизительно
относящихся: относящихся
марс: марсом
взаимодействие: взаимодействием
древний: древний древнее
орбита: орбиты орбита
ударный: ударных ударного ударном
место: места место
вопрос: вопрос
существовать: существует
самый: самых самым
выброшены: выброшены
ранее: ранее
степень: степени
переход: переходе
цирконам: цирконам
получено: получено
возникшего: возникшего
сформировавшиеся: сформировавшиеся
отмечены: отмечены
цифра: цифры
возмущающим: возмущающим
произошел: произошел
остальной: остальной
желтыми: желтыми
получившие: получившие
точный: точные
европа: европой европе
солнце: солнца
небольшой: небольшого
железо: железа
отрицать: отрицают
подледного: подледного
сохраняться: сохранялся
примирить: примирить
лунный: лунная лунных лунной лунного лунные
больший: большего
одну: одну
полученный: полученный
малый: малых
низкий: низкое
роль: роли
чанъэ: чанъэ
состояние: состояние
обеднение: обеднению
термический: термических
протоземли: протоземли
фрагмент: фрагменты
проявленный: проявленный
расчеты: расчеты
оставаться: остаются
перераспределение: перераспределению
полный: полная полное полного
отдельный: отдельные
перемещение: перемещении
главное: главным
журнал: журнале
делать: делают
океан: океана
этап: этапу этап этапе этапы
ученые: ученые
возникающая: возникающая
лёд: льда
подобный: подобная подобных
владислав: владислав
пересечение: пересечении
датировка: датировки
оставшимися: оставшимися
воздействие: воздействием
тип: типах
эйткен: эйткен
