рнк: рнк
никакой: никаких
стероидных: стероидных
частность: частности
близкий: близким близки близких
лежать: лежат
патогенный: патогенной
бессмертие: бессмертием
совершенный: совершенно
пример: примерами
подобный: подобные подобная
репликацией: репликацией
выключаться: выключаются
сползаться: сползаются
прочтение: прочтения
голод: голода
скот: скот
вплоть: вплоть
фосфоинозитидами: фосфоинозитидами
регуляция: регуляцию
гликогена: гликогена
вопрос: вопросы вопроса вопрос
энергия: энергии энергию
протеинкиназа: протеинкиназа
ветвь: ветви
швеция: швеции
формировать: формировать
сравнение: сравнения
неясный: неясны неясно
анализ: анализ
диктиостелиями: диктиостелиями
хотеться: хотелось
агрегативной: агрегативной
агрегация: агрегация
акразий: акразий
конечный: конечная
вторичный: вторичными
серпантинный: серпантинный
количество: количество количества
жертвовать: жертвует
транскриптома: транскриптома
пища: пища
перспективный: перспективной
отделены: отделены
метаболически: метаболически
аденозин: аденозин
исполняя: исполняя
синий: синего синий
агрегат: агрегат
устроена: устроена
мутант: мутанты
оказаться: оказалась оказалось оказался
план: планом плане
амеба: амеба
трудный: трудно
центр: центре
разный: разных разными
представать: предстают
обеспечивать: обеспечивают
диктиостелид: диктиостелид
образование: образованием образовании
исследовать: исследовать
буквальный: буквальном
сандру: сандру
многоядерную: многоядерную
отдельный: отдельными
превратиться: превратиться превратятся
естественный: естественный
сша: сша
хватать: хватает
активный: активными активно активное активны активный активные активных
знакомая: знакомых знакомыми
сигнальный: сигнальных
присутствовать: присутствуют
сформируется: сформируется
разветвленное: разветвленное
сильный: сильного сильный
высокий: высокий
тирозиновые: тирозиновые
компьютерный: компьютерного
свежеть: свежей
диктиостелиды: диктиостелиды
мембранные: мембранные
голодать: голодать
образовать: образуют
путем: путем
считать: считать
агрегативную: агрегативную
задействованные: задействованные
нейромедиаторы: нейромедиаторы
обман: обмана
развитие: развития
родственный: родственны
начаться: начались
осуществляющих: осуществляющих
дифференцировки: дифференцировки
экспрессия: экспрессии экспрессию экспрессия
ветка: ветки
действие: действии действие
любопытный: любопытно
деталь: деталях
отсутствие: отсутствия отсутствие
оптимизм: оптимизм
деятельность: деятельности
общий: общим общего общих
лебединый: лебединую
малый: малыми
абсолютный: абсолютно
амеб: амеб
тип: тип
митоген: митоген
упадок: упадок упадка
самопереваривание: самопереваривание
тело: тела тел тело теле
недавний: недавнего
возникать: возникала
популяция: популяциях
обходиться: обходится
размножение: размножение
стащить: стащила
такой: таким таких
целить: цель
вероятность: вероятность
смысл: смысле
полета: полета
гомолог: гомолог
особый: особому
единый: единую
перенос: переноса
очевидный: очевидно
уровень: уровне уровень
изучены: изучены
масштаб: масштаб
самопереваривания: самопереваривания
протеасом: протеасом
диктиостелия: диктиостелия
эмбриотоксичность: эмбриотоксичность
активируемые: активируемые
гриб: грибы гриба грибов
компонент: компонентами компонентов компоненты
рнказ: рнказ
будучи: будучи
гтфазами: гтфазами
стадия: стадиях стадии стадия
являться: являются является
грибоживотное: грибоживотное
дикстиостелиевых: дикстиостелиевых
заканчиваться: заканчивается
позволять: позволяют
обманывать: обманывать
неудивительный: неудивительно
существо: существо
число: число
слизевиком: слизевиком
открытый: открыты открытый
изменение: изменения
конец: конца
гистидиновых: гистидиновых
высота: высоты
взгляд: взгляда
доказательство: доказательств
схема: схема схемами
самособравшегося: самособравшегося
вместить: вместить
дальнейший: дальнейшую
серотонин: серотонин
жизненный: жизненный жизненного
растение: растений растения
биохимик: биохимику
георгий: георгий
клетка: клетки клеток клетку клеткам клетках клетками клетке клетка
весь: всей
например: например
животное: животных животные животными
вроде: вроде
охотиться: охотятся
открытие: открытие
формирование: формирования формирование
свет: свет света
поэтому: поэтому
след: следов
устроенный: устроен
диктиостелиевых: диктиостелиевых
дальний: далее
оставаться: остаются
попасть: попал
источник: источник
сотня: сотнями
часть: часть
ножка: ножки
наоборот: наоборот
фосфоинозитидного: фосфоинозитидного
удивительный: удивительным
одна: одна
обрести: обрести
пузырёк: пузырьков
задействуется: задействуется
путь: пути путей
индуктор: индукторов
небиологам: небиологам
попытка: попытка попытку
совокупность: совокупности
акразиды: акразиды
балдауф: балдауф
диктиостелий: диктиостелий
говоря: говоря
получить: получат
норадреналин: норадреналин
менингоэнцефалита: менингоэнцефалита
читатель: читателям
цепочка: цепочки
протеинкиназы: протеинкиназы
геном: генома геному
начинать: начинают
агрегативная: агрегативная
данные: данных данным
большинство: большинство
включая: включая
другой: другими
примерно: примерно
поистине: поистине
опубликовать: опубликовала опубликовали
включаться: включаются
синтез: синтеза
повышался: повышался
метаболические: метаболические
небольшой: небольшое
общественный: общественных
оставаясь: оставаясь
обсуждаемой: обсуждаемой
конкурент: конкурента
лекция: лекцию
повысить: повысить
отсеквенированного: отсеквенированного
многоклеточность: многоклеточность
препятствовать: препятствовало
моментальный: моментально
узнать: узнать
рисунок: рисунок
сложный: сложный сложного сложное сложным
пытающихся: пытающихся
воспользоваться: воспользовалась
экспрессирующихся: экспрессирующихся
группа: группа группы
добыча: добыча
мишень: мишени
опосредует: опосредует
называемых: называемых
простой: проста простой проще
новый: новом новых нового
рассеиваться: рассеиваются
начиная: начиная
набор: набором
эукариотам: эукариотам
работать: работать работают
известный: известные известны известного
идентифицированы: идентифицированы
многоглавый: многоглавый
слизевику: слизевику
составлять: составляет
адреналин: адреналина
молекулярный: молекулярные молекулярном молекулярных
момент: моменту момента момент
привлекать: привлекают
отношение: отношении
различие: различия
неожиданность: неожиданность
пронаблюдали: пронаблюдали
клон: клон
социальный: социальные
есть: ест
продолжать: продолжают
процесс: процессе процесс процесса процессом
повторенный: повторенный
активность: активности
состоять: состоит
удивление: удивление
международный: международная
место: место
похожий: похожи похожа
основа: основе
амебе: амебе
многоклеточности: многоклеточности
фото: фото
выдает: выдает
зря: зря
одним: одним
задействует: задействует
представляя: представляя
рост: роста рост
минималках: минималках
продуктивный: продуктивен
уметь: умеют
эксперимент: эксперимент
архэ: архэ
птичий: птичьего
переставать: перестают
жизнедеятельность: жизнедеятельность
завершение: завершение
красота: красотой красоте
толк: толком
условие: условиях
эволюция: эволюции
развиваться: развивается
лекарство: лекарств
воспринимать: воспринимают
история: историю история
коллективный: коллективное
максимальный: максимальной
отметить: отметить
озерной: озерной
вместо: вместо
грибоподобное: грибоподобное
чрезвычайный: чрезвычайно
сложность: сложностью
удивлять: удивляет
подробный: подробно
докатиться: докатились
точка: точек
второй: вторая
настолько: настолько
ген: геном генов генам гены генами
поражать: поражают
некоторые: некоторые некоторыми
усилие: усилия
сохраняться: сохраняется
млекопитающий: млекопитающих млекопитающего
большой: большой большое
судьба: судьба
огромный: огромный
особенность: особенности
связанный: связанных связан
умирающий: умирающих
споруляция: споруляция
сигнализация: сигнализации
хищный: хищная
сельский: сельское
составленная: составленная
писать: писал
разрушение: разрушения
твердой: твердой
задействовано: задействовано
фонтикулид: фонтикулид
образующиеся: образующиеся
формирующие: формирующие
агрегации: агрегации
черта: чертах
несмотря: несмотря
горизонтальный: горизонтального
многие: многие
описанный: описаны
специалист: специалиста
интронов: интронов
востребован: востребован
выясниться: выяснилось
амебоидных: амебоидных
физарум: физарум
минималистичностью: минималистичностью
какой: какие какого
бактерия: бактерий бактерии
земля: земле
элемент: элементы
проверка: проверки
давать: дают
обеспечивая: обеспечивая
возбудитель: возбудителей возбудителям
организм: организмов организма организме
основный: основные основных
акразия: акразия
последующий: последующей
одиночный: одиночных
ключевой: ключевых ключевые
сходный: сходна
слизевик: слизевик
препарат: препаратов
концентрация: концентрации
править: правило
больший: большую большей
пролить: пролить
усиленный: усиленного
посредник: посредниками
куракин: куракин
называться: называется называются
расщепление: расщепление
обречённый: обречены
цамф: цамф
гистидинкиназы: гистидинкиназы
представить: представить представили
споруляцией: споруляцией
защита: защиты
саморазрушающихся: саморазрушающихся
клональным: клональным
многократный: многократно
аутофагосом: аутофагосом
дело: дело деле
мой: мою
сопряженный: сопряженный
транскриптом: транскриптом
характерный: характерные
ответ: ответ
хороший: хорошую
пероксисомам: пероксисомам
фундаментальный: фундаментальные
обнаружено: обнаружено
примитивный: примитивных
состав: составе
раковый: раковым
делиться: делятся
образ: образом
массы: массы
вызывающий: вызывающей
представленный: представлена
основы: основы
вид: вида виде
разветвленные: разветвленные
связана: связана
выглядеть: выглядит
наших: наших
рецептор: рецептор рецепторы рецепторов
разводить: разводит
изменять: изменяют
фермент: ферментами ферментов ферменты
цианобактерии: цианобактерии
менингоэнцефалит: менингоэнцефалит
клеточный: клеточными клеточных клеточные клеточной
единственный: единственным
объесть: объем
сплайсинга: сплайсинга
независимый: независимо
регуляторным: регуляторным
недостаток: недостатка
касаться: касается
изученных: изученных
хемоаттрактанты: хемоаттрактанты
изучение: изучению
дания: дании
развить: развили
летальный: летальный
контрольный: контрольных
слизевика: слизевика
биолог: биологов
сливаться: сливаются
рассеяться: рассеяться
вообще: вообще
эпителий: эпителию эпителий
интересный: интересно
метаболизмом: метаболизмом
структура: структур структуры
однородный: однородный
мясорубка: мясорубок
крайний: крайне
слизевиками: слизевиками
сытый: сытом
прорастать: прорастают
таковой: таковы
меньшой: меньшая
биоинформатиков: биоинформатиков
начать: начало
результат: результаты
формируют: формируют
агрегацию: агрегацию
амебы: амебы
акразии: акразии
позаимствовать: позаимствовать
каждый: каждого каждой
жизнь: жизни
старение: старения
система: системы
неблагоприятных: неблагоприятных
начнется: начнется
поведение: поведение
трипаносомам: трипаносомам
проверять: проверяли
повышенный: повышен повышенного
днк: днк
дифференцировку: дифференцировку
свободноживущих: свободноживущих
форма: форма
метод: методом
минимальный: минимальным
регуляторные: регуляторные
болезнь: болезни
связаны: связаны
относительный: относительно
генетический: генетически
выделять: выделять
акразинами: акразинами
исследователь: исследователей исследователи
наступать: наступают
плодовый: плодовые плодовых плодового плодовое плодовом
человек: человека
песнь: песнь
любой: любому
огрублять: огрублять
препринта: препринта
водоросль: водорослей
неглерии: неглерии
регулирующие: регулирующие
включающей: включающей
построение: построения построению
происходить: происходят происходит
понять: понять
эукариот: эукариот
акразина: акразина
фоулера: фоулера
слизевиков: слизевиков
использованный: использовано
работа: работе работа
спор: споры спор
вместе: вместе
инопланетный: инопланетного
расстояние: расстояние
посоперничать: посоперничать
тот: той
эволюционный: эволюционной эволюционно эволюционное
следовать: следует
сожаление: сожалению
повышается: повышается
использовать: используют
аденозиновые: аденозиновые
необычный: необычные необычного необычна
сайт: сайта
хозяйство: хозяйство
белковый: белков
шанс: шанс
разделяющее: разделяющее
фосфолипаза: фосфолипаза
долгожданный: долгожданным
начинаться: начинается начинаются
свой: свой своим своими
статус: статус
обманщик: обманщики
шляпка: шляпки
фотография: фотографиями
белка: белки белок белка
вычурный: вычурны
конференция: конференции
слизевики: слизевики
заодно: заодно
митохондрии: митохондрии
разработка: разработки разработку
внутриклеточных: внутриклеточных
предстоять: предстоит
представитель: представителя
родственник: родственником родственников
гормон: гормонов
великий: великого
исследование: исследования исследований
опухоль: опухолей
разрушаться: разрушаются
эмбрион: эмбрионов
механизм: механизмы механизмов
знать: знали
ноябрь: ноябре
деление: деления деление
называть: называют
вполне: вполне
последний: последнего
найти: нашли
семейство: семейства
ученые: ученые
амёба: амёбы амёб
представлять: представляют представляет
возникновение: возникновению
нервный: нервной
прочитанный: прочитанного прочитанный
помочь: поможет
потомок: потомков
состояние: состоянии
рассеяние: рассеяния
сонный: сонной
рис: рис
раздельный: раздельной
дисковидный: дисковидного дисковидный
многоклеточный: многоклеточных многоклеточного многоклеточный многоклеточной многоклеточным
одноклеточный: одноклеточная одноклеточных одноклеточной
постепенный: постепенно
показывать: показывают
цикл: цикл цикла циклом цикле
трихомонадам: трихомонадам
ход: ходе
транскриптомный: транскриптомный
смертность: смертностью
стандартный: стандартным
статья: статье статью статьи статья
отличие: отличие
гибель: гибель
сходство: сходства
иметь: имела
впервые: впервые
злокачественный: злокачественных
прежде: прежде
киназы: киназы
трихомонад: трихомонад
изучить: изучить
природа: природы
журнал: журнале
рапамицина: рапамицина
задействованы: задействованы
вступать: вступают
частить: части
