всасывающий: всасывающая
выжить: выжить
точка: точки
фундаментальный: фундаментальными
гиперосмолярную: гиперосмолярную
соответствующий: соответствующем
сфокусировались: сфокусировались
впасть: впасть
усиленный: усиленно
выясниться: выяснилось
некоторые: некоторые
очевидный: очевидно
нагрузка: нагрузка нагрузку
пересечет: пересечет
потолстеть: потолстели
хотеть: хотели
разнообразный: разнообразен
весь: всей
инсулинорезистентны: инсулинорезистентны
регуляция: регуляция регуляции
полоть: полете полет
нарушаться: нарушаются
заманчивый: заманчиво
поджелудочный: поджелудочной поджелудочная
возможность: возможности
расчете: расчете
теоретический: теоретических
мутация: мутации
хронически: хронически
пациент: пациентов
должный: должны должен
перейти: перешла
счастье: счастью
адаптация: адаптация
одними: одними
приводить: приводит
настолько: настолько
усвоение: усвоения
повышается: повышается
флорида: флорида
расщепление: расщепления
звено: звена
наступление: наступления наступление
переносить: переносит
сожаление: сожалению
функциональный: функциональный
медленный: медленно
экстремальных: экстремальных
вероятный: вероятно вероятным
быстрый: быстро быстрому
кровь: крови кровью кровь
инсулиннезависимому: инсулиннезависимому
считанные: считанные
орган: органов
заставлять: заставляет
эквивалент: эквивалента
внутрь: внутрь
узнать: узнать
исследователь: исследователи исследователей
счет: счет
касаться: касаются
утилизировать: утилизирует
молниеносный: молниеносному
включать: включало
располагающийся: располагающийся
качество: качестве
снижение: снижению
секреция: секреции секрецию
куракин: куракин
человек: человека людей
журнал: журнале
остановить: остановить
конец: конца
больший: большие
выделяться: выделяется
обсуждаемой: обсуждаемой
запускающего: запускающего
повысится: повысится
отказ: отказу
фермент: фермент
ямайский: ямайский
другой: другому
мембрана: мембранах мембране
видимость: видимости
каемке: каемке
одну: одну
пищевой: пищевые
анатомический: анатомических
подниматься: поднимается
несмотря: несмотря
питание: питании питание питания
вода: воду
использовать: используют
ночницы: ночницы
тело: тела
ускоренный: ускоренной
циркулирующего: циркулирующего
состав: составу состав состава
гиперосмолярная: гиперосмолярная
переносчик: переносчики переносчик
диабет: диабету диабета диабет диабетом диабете
организм: организм
значение: значениях
ген: генах
тратиться: тратится
мозг: мозга
первый: первых
данные: данные
показывать: показывают
фруктоядная: фруктоядная
доза: дозу
выживать: выживать
мочь: можем
мышей: мышей
потребность: потребности
нарушение: нарушению
америка: америке
константа: константами
компонент: компонентом
количество: количеств
размер: размера
нарушена: нарушена
сахарный: сахарному сахарного сахарный сахарным сахарном
падение: падения
широкий: широкий
липидного: липидного
процесс: процессе
колибри: колибри
сайт: сайта
третий: третьи
смерть: смерть смерти
отметка: отметку
сладкое: сладкого
биоинформатики: биоинформатики
углеводный: углеводного
порог: порог
георгий: георгий
кетоацидозу: кетоацидозу
развиваться: развивается
рекордсмен: рекордсменом рекордсмен
являться: является
следствие: следствие
инсулиновая: инсулиновая
секрет: секрет
полететь: полетит
фото: фото
результат: результаты
сходный: сходная сходный
неизбежный: неизбежное
проживать: проживают
привести: привести привели
править: правило
неотропике: неотропике
листонос: листонос
сей: сего
гиперосмолярной: гиперосмолярной
среди: среди
перегрузка: перегрузки
диарея: диарею диареей
смертельный: смертельного смертельную смертельных
сахар: сахара сахарами сахаров
научиться: научилась научились
строй: строя
нектароядные: нектароядные
род: родов рода
цитоплазма: цитоплазма
присутствие: присутствие
плохой: хуже
инсулиновым: инсулиновым
попутный: попутно
следовать: следует
след: следов
повышение: повышении
сфокусировавшись: сфокусировавшись
физический: физическая
рыба: рыбу
частичный: частично
исследование: исследование исследования исследовании
обе: обе
накопить: накопили
побочный: побочных
связана: связана
торт: тортами
строение: строения
химический: химическому
обеспечиваться: обеспечивается
оказаться: оказались оказалась
дефектными: дефектными
применить: применить
велик: велика
последствие: последствия
десерт: десертами
погибнуть: погибнуть
диапазон: диапазоне
колумбия: колумбии
бета: бета
улучшить: улучшить
пищать: пищи пищу
вырабатывать: вырабатывать
трегалаза: трегалаза
рацион: рацион рационам
вмешательство: вмешательства
автор: авторы
большой: большое
вариабельно: вариабельно
всасывание: всасывания всасывание
интересный: интересную
рецепт: рецепт
клетка: клетки клеток клетках клеткам
возможный: возможных
углевод: углеводов углевода
экспрессируется: экспрессируется
непонятный: непонятно
система: систем
редкий: редко
поверхность: поверхность
тип: типа
современный: современных
группа: группы группе группа
фрукт: фруктами фрукты
дезорганизуются: дезорганизуются
оставляя: оставляя
требовать: требует
пища: пищей пища
создает: создает
одинаково: одинаково
биологический: биологическая
сочетание: сочетании
каждый: каждой
проживая: проживая
примерно: примерно
обитающим: обитающим
метод: методов
меря: мере
начинать: начинает начинают
одинаков: одинаков
тонкость: тонкостей
коэволюция: коэволюция
высокобелковой: высокобелковой
секретирующие: секретирующие
уборка: уборку
животное: животных
снижать: снижает
работа: работы
момент: момента
млекопитающий: млекопитающих млекопитающего
ммоль: ммоль
нейрон: нейроны нейронов
иначе: иначе
глубокий: глубоким
объяснение: объяснений объяснение
норма: норма
достаться: достался
биохимический: биохимической
решить: решили
позволять: позволяет
покрывать: покрывать
метаболизм: метаболизм
необходимый: необходим необходимом необходима
кетоацидотическая: кетоацидотическая
регион: регионе
скапливаться: скапливалась
принадлежащий: принадлежащих
зависеть: зависит
тяжелым: тяжелым
развитие: развитию
поистине: поистине
называемой: называемой
работать: работать работают
реанимация: реанимации
предок: предок
тратить: тратить
похожий: похожими
одно: одно
бассейн: бассейна
картина: картину
живший: живший
разлететься: разлетелись
вытягивать: вытягивает
разный: разным разные
меньший: меньшее меньшей
повышенный: повышенного
молекула: молекулу
общий: общий
запрещать: запрещают
моль: моль
дальнейший: дальнейшего
глюкоза: глюкозы глюкоза глюкозой глюкозу
изменение: изменениям изменения
диета: диете диетой
план: план
представление: представлений
путь: пути
уровень: уровень уровня уровнях уровне уровню
впадать: впадают впадать
врач: врачи
способный: способны способна
отличаться: отличаются
трегалозу: трегалозу
бояться: боюсь
концентрация: концентрация концентрацией
длиннопалые: длиннопалые
опубликовать: опубликовала
кетоновые: кетоновые
большинство: большинства
сенсора: сенсора
простой: простое
метаболизма: метаболизма
сцеплены: сцеплены
повезти: повезло
частность: частности
белка: белках белки белок белка
зверёк: зверьков зверьку
имеющийся: имеющихся имеющиеся
обнаруживаться: обнаруживалась
подъему: подъему
наступать: наступает
остров: острова
стать: стала
кома: комы
меньшой: меньших
высокий: высокого высокая высоких выше высокой высокий высоким высокому
вампиризм: вампиризм
ловить: ловить
любители: любители
отбор: отбора
домене: домене
двигаться: двигаться
эволюционный: эволюционные эволюционных эволюционное
поиск: поиска
чувствовать: чувствует
реагировать: реагирует
низкий: низким
буквальный: буквальном
кетоацидоза: кетоацидоза
растительный: растительную
просвет: просвета просвете
неясный: неясно
такой: таких такого таком
отловлено: отловлено
столько: столько
бразильский: бразильский
функция: функции
карибского: карибского
аномалия: аномалия
мышь: мышам мыши мышь
копьенос: копьенос
инсулин: инсулином инсулин инсулина
жир: жирах
денатурироваться: денатурироваться
элегантный: элегантное
запускать: запускает
избыточный: избыточная
сигнализация: сигнализация
поменяться: поменялись
трегалозы: трегалозы
итог: итогам
полный: полного
фруктоядных: фруктоядных
осмотический: осмотическое
ответ: ответ ответом
одни: одни
поэтому: поэтому
условие: условиях
гемолимфе: гемолимфе
удивительный: удивительные
статья: статье статьи
пик: пике
разочаровать: разочаровать
сладкоежки: сладкоежки
впадет: впадет
самый: самые самых самым
целить: цели
чрезвычайный: чрезвычайно
крайний: крайней
предпочтение: предпочтения
медицинский: медицинского
насекомоядный: насекомоядных
подвергаться: подвергался
регулируется: регулируется
хронический: хронической
противодиабетический: противодиабетический
входить: входят
длинный: длиннее
постоянный: постоянно постоянная
перенять: перенять
сладкий: сладкой сладкую
специализироваться: специализируются
ограниченный: ограничен
трегалозе: трегалозе
многие: многие
устроены: устроены
спектр: спектр
энергия: энергии энергию
обычный: обычный
электролитный: электролитный
источник: источник
состояние: состоянии
биогеографическом: биогеографическом
различие: различия
маленькая: маленькая
активность: активность
достигать: достигать достигает
охотиться: охотился
железа: железы
повезет: повезет
делать: делают
летучий: летучих летучие летучим летучая
эффективный: эффективно
зрение: зрения
выделяющийся: выделяющийся выделяющегося
железо: железа
рис: рис
эволюция: эволюции
сша: сша
моносахаридных: моносахаридных
богатый: богатой
устойчивость: устойчивости
тяжелейший: тяжелейшему
деятельность: деятельности
способность: способность
цитоплазмы: цитоплазмы
физиологического: физиологического
мышечный: мышечная
эпителий: эпителия
затруднить: затруднило
минута: минуты минут
исключительный: исключительно
сразу: сразу
обмен: обмена обмену
обратно: обратно
скорый: скорее
единственный: единственный
насекомое: насекомыми насекомых насекомые
элемент: элементы
получить: получит получить
жить: живут жить
обнаружить: обнаружили
избежать: избежать
любой: любого любая
заполучить: заполучить
особенность: особенности особенностях
отследить: отследить
роковую: роковую
открытие: открытия
лежать: лежат
ниша: нишам
остаться: осталась
случайный: случайно
попробовать: попробует
доходить: доходят
препарирование: препарирования
методика: методик
подобный: подобном
резерв: резерв
питающихся: питающихся
контроль: контроль
нектароядных: нектароядных
экологический: экологическим
адаптаций: адаптаций
основный: основного
абсолютный: абсолютным
трапеза: трапезой
четвертые: четвертые
усваивать: усваивать
ком: кома коме
эффект: эффектов
максималках: максималках
вид: видов виды видам
приведет: приведет
сильный: сильно
периферических: периферических
остается: остается
часть: часть
например: например
тонкий: тонкого
экспрессия: экспрессия
долгий: дольше
кишечник: кишечнике кишечник кишечника
чудо: чудом
потомок: потомки
выйти: выйдут
чувствительный: чувствительные
метода: методами
еда: еды
ясный: ясно
нектар: нектаром нектар
питаться: питаться питаются
давление: давление давления
фруктоядные: фруктоядные
классический: классических
циркулировать: циркулирует
медицина: медицине
закислению: закислению
решение: решение
одном: одном
вызывая: вызывая
гликемии: гликемии
млн: млн
неприятный: неприятные
смысл: смысле
освоить: освоили
латинский: латинской
ожидаемыми: ожидаемыми
щеточной: щеточной
позволяя: позволяя
исходя: исходя
загадка: загадка
ткань: тканях
способ: способ
