ассоциация: ассоциация
соляный: соляных
связана: связана
декабрь: декабря
порода: породами пород
секущий: секущие
расслоение: расслоением
пирссонит: пирссонит
выбрать: выбрать выбрала
азот: азота азотом
связывать: связывали
нахождение: нахождения
первозданный: первозданное
говорить: говорить
начаться: началось
пустыня: пустыне
защитить: защитить
конгломерат: конгломерат
концентрирование: концентрирование
вообще: вообще
открытие: открытие
натрий: натрия натрием
аденин: аденин
хлорид: хлориды хлоридов хлорида
сохранить: сохранить
белковый: белковых
приземление: приземления
корабль: корабля
происходить: происходил происходит происходило
ледяной: ледяное
энцелада: энцелада
присутствующий: присутствующих
выбор: выбор
перчаточный: перчаточном
крупный: крупных крупной крупные
представляющем: представляющем
зафиксированы: зафиксированы
усыхания: усыхания
гидратированные: гидратированные
указывающие: указывающие
обнаружение: обнаружении
меняться: менялась
обломки: обломков
наса: наса
состояние: состояние
распределенный: распределенный
откладываться: откладывались
предположительно: предположительно
каменистый: каменистая
бокс: боксе
образованный: образованных образованным
приток: приток
журнал: журнале
некоторый: некоторое
светлый: светлый
наличие: наличие
предназначенный: предназначенный
кратер: кратер кратере
заполненный: заполненный
нуклеиновых: нуклеиновых
галит: галит
отметить: отметить
сентябрь: сентября
ученые: ученые
достигнув: достигнув
взятие: взятия
ловушка: ловушку
серпентин: серпентин
владислав: владислав
качество: качестве
контакт: контакта
состояться: состоялся
расположенный: расположены
отмечать: отмечают
сотня: сотен
повышение: повышения
развитие: развития
осуществляться: осуществлялся
выполняться: выполнялись
хаябуса: хаябуса
микроскопия: микроскопии микроскопия
сканирующая: сканирующая
аналог: аналогом
сбор: сбора
рюгу: рюгу
взаимоотношение: взаимоотношений
нахколита: нахколита
подобный: подобными
перемешивание: перемешивание
трещина: трещины
элемент: элементами
штат: штате
сша: сша
присмотреться: присмотреться
фосфатов: фосфатов
аналогичный: аналогичные аналогичной
хранившимися: хранившимися
опубликованы: опубликованы
метеоритный: метеоритного
псевдогексагональных: псевдогексагональных
подтверждаться: подтверждается
край: краям
система: системы система
выдвинуться: выдвинулся
новый: нового
этап: этапа
сатурна: сатурна
зерен: зерен
вернуться: вернулась
углистым: углистым
информация: информации
образовать: образуют образует
встречаться: встречаются
сканирующей: сканирующей
результат: результаты результатов результате
рассол: рассола рассолов рассолом
мнение: мнению
манипулятор: манипулятор
установить: установил установить установили
углерод: углеродом углерод
сульфат: сульфат
усыхающих: усыхающих
электронный: электронной электронный электронная
развиваться: развиваются
солевых: солевых
указывать: указывает
который: которыми которому
самый: самых самая самым
тип: типа
вариант: варианты
случай: случае
сверху: сверху
герметичный: герметичного
соответствие: соответствии
откуда: откуда
полный: полное
карта: карту
древние: древних
внутри: внутри
фиолетовый: фиолетовый
набор: набор
испарительной: испарительной
тело: теле тело тел тела
получить: получить
мкм: мкм
момент: момент
последовательный: последовательное последовательно
щелочности: щелочности
составленное: составленное
усеянной: усеянной
материал: материала материал
необходимый: необходимые необходимыми
показатель: показатель
группа: группе групп
отражены: отражены
вполне: вполне
сульфата: сульфата
оказаться: оказалась
какой: какого
маневр: маневра
рентгеноструктурный: рентгеноструктурный
заполнять: заполняли
насыщение: насыщения
линейка: линейку
сульфидами: сульфидами
цитозин: цитозин
космический: космический космического
миро: миру
приближение: приближении
пробоотборник: пробоотборник
характер: характер
опубликованная: опубликованная
минеральный: минеральный минерального минеральных минеральной
лаборатория: лаборатории
вес: вес
сильный: сильно
исходный: исходного
содержащий: содержащим содержащие
состоящем: состоящем
интересный: интересно
десяток: десятков
вещество: вещества вещество
камера: камерой
магний: магния
сульфатов: сульфатов
считать: считают
родительский: родительском родительского
спектральный: спектрального
следовать: следует
помощь: помощи
листовые: листовые
листовых: листовых
доломит: доломитом доломита доломит
проба: пробы пробами проба проб
подробный: подробную
команда: команда
популяция: популяций
обсуждаемой: обсуждаемой
служить: служат
собраться: собрался собрались
исследовательский: исследовательские
высокий: высокая
зондирование: зондирование
электрон: электронах
установленный: установленная
октябрь: октября
больший: больших большая
дистанционный: дистанционное
жидкость: жидкости
текущий: текущего
зарождение: зарождения
ход: ходе
ранее: ранее
биология: биологии
достаточный: достаточно
либо: либо
распределить: распределили
включение: включениями
ранний: ранних ранние
озеро: озера озеро
образование: образования образований образование
поток: потоком
магнетит: магнетитом магнетита магнетит
воздействие: воздействия
бенну: бенну
выглядеть: выглядел
условный: условное
природа: природу
источник: источник
июнь: июне
многие: многие
аморфный: аморфные
снимок: снимок
вероятность: вероятность
условие: условиях условиями условия
иметь: имеют имела
глубина: глубинах
юта: юта
астероид: астероида астероидов астероидам астероид астероиду
фторидов: фторидов
агрегат: агрегатов агрегаты агрегата
матрица: матрице
стадия: стадию стадии стадиях
капсула: капсула
наблюдение: наблюдения
кристаллизация: кристаллизации
углеродистый: углеродистое
проводить: проводил
соловеть: соловей
внутренний: внутренней
силикат: силикаты силикатами силикатах силикатов
микрозондовый: микрозондовый
выявить: выявило
калифорний: калифорнии
реголита: реголита
жидкий: жидких жидкой
железо: железа
минерализации: минерализации
присутствовать: присутствовала
жизнь: жизни
превзойти: превзошло
представленный: представлены
включая: включая
лоток: лотков лоткам
сложённый: сложены
тимин: тимин
фаза: фазы
подводящих: подводящих
обогащенность: обогащенность
стрекопытов: стрекопытов
океан: океаном
найтингейл: найтингейл
подповерхностным: подповерхностным
пирротин: пирротин
перейти: перешла
второй: вторая
небелковых: небелковых
интерпретация: интерпретации
извлечен: извлечен
сильвин: сильвин
жила: жилы
аминокислота: аминокислот
сохранившееся: сохранившееся
отрезок: отрезков
виллиомит: виллиомит
озер: озер
запущенный: запущен
забор: забор
изображение: изображение
последовательность: последовательность
изменение: изменения
целый: целый
сжатый: сжатого
править: правило
обычный: обычных
воздух: воздухом
карбонат: карбонаты карбонатов карбонатами карбоната карбонатом карбонат
внеземном: внеземном
умеренный: умеренных
существовавшего: существовавшего
последний: последних последними
доставленных: доставленных
близкий: близок близким
чрезвычайный: чрезвычайно
отлагаться: отлагались
тот: той
возможный: возможно
аммиачный: аммиачными
проанализировать: проанализировали
обнаружить: обнаружили
испарение: испарения испарении испарение испарением
спутник: спутника
гидратированными: гидратированными
соль: соли
вверху: вверху
поверхность: поверхности поверхность
валун: валунами валунов
вскрытие: вскрытие
течение: течение
включающий: включающий
типичный: типичных типичные
составляющая: составляющей
млрд: млрд
водный: водной водного
мелкий: мелких
несущий: несущими
использовать: использовали
гуанин: гуанин
миссия: миссии миссией
вода: вода
позволить: позволили позволило
протопланетное: протопланетное
эвапоритовой: эвапоритовой
исследование: исследования исследований
земля: землю земле земли
фосфаты: фосфаты
частица: частиц частицы
японский: японской
отсутствовать: отсутствуют
редкий: редких
реголит: реголит
частить: части
просвечивающей: просвечивающей
магнезит: магнезитом магнезит
участок: участок
целовать: целую
реакция: реакции
минералообразования: минералообразования
доставка: доставки
земной: земную земных земной земным
формировались: формировались
найдены: найдены
вышедшей: вышедшей
обратно: обратно
первичный: первичное
проблема: проблем
слабосцементированный: слабосцементированный
трон: троны
обнажиться: обнажился
нетронутый: нетронутый
заполняющих: заполняющих
зерно: зерна
резервуар: резервуаров
сайт: сайта
статья: статьи статье статья статей
выпадение: выпадение
данный: дано данном
целевой: целевой
восьми: восьми
кристалл: кристаллов
отложение: отложение отложения отложениях
азотистый: азотистыми
класс: класса
температура: температурами температур
мочь: могли могло
масштаб: масштаба
сюрприз: сюрпризом
сульфиды: сульфиды
минерализация: минерализация
эволюция: эволюция
заметить: заметить
планета: планеты
перенос: перенос
хранение: хранению
органический: органическими органической
пустота: пустоты
относиться: относится
отдельный: отдельных
соединение: соединения соединениями
меря: мере
ракурс: ракурсах
содержать: содержать
оксид: оксиды
концентрированный: концентрированных
закрытый: закрытые
химический: химическому
грунт: грунта грунте
принадлежать: принадлежит
место: место местам
глинистый: глинистые глинистых
магнезиальных: магнезиальных
фосфор: фосфор
множество: множество
разный: разных
различный: различные
классический: классической
сульфаты: сульфаты
эвапоритовую: эвапоритовую
масштабный: масштабного масштабных
собранный: собранная
фосфата: фосфата
одна: одна
длина: длиной длина
цереры: цереры
окисление: окислением
микрометр: микрометров микрометры
свидетельствовать: свидетельствуют
фториды: фториды
обусловленный: обусловлен
орбита: орбиты орбиту
извлечь: извлекли
никакой: никакой
углистые: углистые
организм: организмов
автор: авторы авторам авторов
пыль: пыль
карликовый: карликовой
вероятный: вероятно
полностью: полностью
биологический: биологических
весь: всей
вкрапление: вкраплениями
длительный: длительная
времен: времен
повехности: повехности
астероидного: астероидного
оценка: оценкам
калий: калия
нейтральный: нейтральной нейтральных
игольчатый: игольчатые игольчатых игольчатого
потерять: потеряли
состав: состав состава составу
сторона: стороны
специализированном: специализированном
размер: размер размером
осаждение: осаждение
отрезка: отрезка
собрать: собрали
исследователь: исследователь исследователи
ксеноморфных: ксеноморфных
сравнение: сравнению
водоема: водоема
итог: итоги
грамм: грамма граммов
сформировались: сформировались
след: следы следами
серлс: серлс
космос: космосе
хондриты: хондриты
форма: формах
аппарат: аппарат аппарата
молодой: молодым
последующий: последующего последующим
среда: среде среда среды
листовыми: листовыми
четырех: четырех
посадка: посадки
водорастворимых: водорастворимых
хондритах: хондритах
учитывая: учитывая
неизвестный: неизвестных
внешний: внешней
комплекс: комплекс
рисунок: рисунок
скопление: скоплений
отложились: отложились
посвящена: посвящена
рис: рис
ученых: ученых
прежде: прежде
гидратированных: гидратированных
название: название
получивший: получивший
беспрецедентный: беспрецедентный
вид: виде
обнаружено: обнаружено
солнечный: солнечной
контейнер: контейнера контейнер
отток: отток
составить: составить составил
соответствовать: соответствуют
изучение: изучения изучению изучение
атмосфера: атмосферы атмосфере атмосферой
извлеченных: извлеченных
рассеянный: рассеянных
образец: образцами образцов образцах образец образцы
достигнуть: достиг
работа: работы
пересыщенных: пересыщенных
основание: оснований
сформировался: сформировался
помещенные: помещенные
относительный: относительно
вегшайдерита: вегшайдерита
содовый: содовых
фторид: фторид
гейлюссит: гейлюссит
протопланет: протопланет
граничный: граничными
фото: фото
околоземный: околоземных
раскладной: раскладной
похожий: похожа
кальцит: кальцитом кальцита кальцит
зональный: зональные зонального
осаждались: осаждались
перевести: перевести
сделанных: сделанных
вместе: вместе
шлейф: шлейфах
очередь: очередь
месяц: месяцев
безопасный: безопасного
отправленный: отправлены
объект: объекта
метеорит: метеоритов
насыщенный: насыщенных
пробоотборника: пробоотборника
выброс: выбросов
красный: красный
эвапоритовые: эвапоритовые
чей: чьи
помимо: помимо
замерзание: замерзании замерзанием
прибор: приборами
контрольный: контрольными
обсуждаемая: обсуждаемая
минерал: минералов минералы
пересекать: пересекают
прожилка: прожилки
самостоятельный: самостоятельные
находить: находили
щелочной: щелочной щелочных
гидратацией: гидратацией
аполлон: аполлонам
стать: стало
главное: главным
раствор: растворов растворы раствора
многоэлементный: многоэлементный
поздний: поздними поздние
известный: известного известное
первый: первые первую первом первыми
образоваться: образоваться образуются образовались образовался
анализ: анализа анализ анализу
урацил: урацил
подтвержденном: подтвержденном
остаточный: остаточным
кадр: кадров
непосредственный: непосредственной
головка: головки
определить: определить
галогенидов: галогенидов
объемного: объемного
диаметр: диаметром
отбор: отбор
богатый: богата богатым богат
метод: методов
окаймлять: окаймляют
