дефицит: дефицита
нуклеиновые: нуклеиновые
отсутствовать: отсутствуют
распределение: распределение
жизнь: жизни
обоих: обоих
метанокисляющие: метанокисляющие
сильный: сильно сильнее
бактерия: бактерий бактерии бактериям бактерия бактериями
промышлять: промышляют
ген: генов гены
получены: получены
заражение: заражения
питательный: питательных питательные
хитиназа: хитиназа
протеазных: протеазных
внутриклеточному: внутриклеточному
геном: генома геномы геномов геноме геномах
вирус: вирусами вирусы вирусов вируса
межклеточный: межклеточной
стадия: стадиях стадия стадии
путь: пути
элемент: элементы
тычинки: тычинки
горизонтальный: горизонтальный
главное: главным
выловленного: выловленного
мексиканский: мексиканском
управление: управление
жабры: жабр жабрах жабры
жабер: жабер
предел: пределом
гидротерм: гидротерм
включение: включения
широкий: шире
редкость: редкость редкостью
хозяин: хозяина хозяин хозяев хозяином
гибель: гибель гибелью гибели
хитин: хитин
эволюционный: эволюционно эволюционное
среди: среди
рассмотренных: рассмотренных
каспаз: каспаз
масштаб: масштабов
сегодняшний: сегодняшний
показать: показал
уходить: уходит
гликолиза: гликолиза
метанокисляющих: метанокисляющих
стать: стало стали
род: роды рода
невозможность: невозможность
идентичный: идентичны
филогенетический: филогенетический
хроматин: хроматин
рис: рис
вполне: вполне
известный: известны известно
ретикулума: ретикулума
содержать: содержат содержали
углевод: углеводов
периплазму: периплазму
ограниченный: ограниченно
прорыв: прорывом
встречаться: встречаться
ученые: ученые
симбиотические: симбиотические
переносчик: переносчики
обитание: обитания
достигать: достигают
клад: клада клад
автор: авторы
метаболизме: метаболизме
разнообразие: разнообразие
запускать: запускают
микрофотографии: микрофотографии
паразитический: паразитической паразитическими
изученные: изученные
собственный: собственных
заражающих: заражающих
тканевый: тканевое
организация: организации
используются: используются
выделение: выделением
прокариотам: прокариотам
явный: явно
использующие: использующие
разный: разные разных
питание: питанием питанию питания питании
разница: разницей
одиночный: одиночная
содержащий: содержащие
возможный: возможно
прежде: прежде
микродиссекция: микродиссекция
благодаря: благодаря
близкий: близки
устрица: устриц
обратный: обратного
ядерный: ядерным ядерные ядерных ядерный ядерная
выгода: выгоду
находиться: находятся находится
чужой: чужих
иметься: имеются
выявить: выявила выявил
поздний: поздняя поздней
одно: одно
гибридизация: гибридизации
журнал: журнале
микобактерии: микобактерии
липидах: липидах
молекула: молекулы молекул молекула
опосредованно: опосредованно
вирусный: вирусные
живой: живые
глубина: глубине
получить: получили получила
видный: видны
позаимствованы: позаимствованы
большой: большой
равномерный: равномерно
симбионты: симбионты
килодальтон: килодальтон
задействованы: задействованы
адаптаций: адаптаций
таковой: таковы
полный: полные
протеобактерии: протеобактерии
губка: губок
вызвать: вызвать
пойманных: пойманных
внешний: внешней
удлиняться: удлиняется
антибиотики: антибиотиков
обсуждаемая: обсуждаемая
паразитизм: паразитизму паразитизмом паразитизм паразитизма
система: системы
состояние: состояние
бороться: бороться
парировать: парирует
гонка: гонкой
паразитирующие: паразитирующие
поступать: поступать
прослеживается: прослеживается
близкородственный: близкородственных
растягивая: растягивая
линия: линиями
иммунитет: иммунитета
образец: образцов образцах
извлечены: извлечены
стабильный: стабильно
синтезировать: синтезируют синтезировать
просвечивающего: просвечивающего
красный: красный
рыба: рыб
залив: заливе
стресс: стресс
пунктирный: пунктирными
окрашивающим: окрашивающим
раздувание: раздувание
эукариот: эукариот
явление: явление явлением
тип: типа типом
данные: данных данные
принадлежать: принадлежат
метаболизмом: метаболизмом
жизненный: жизненный жизненного
лаборатория: лаборатории
прокариотах: прокариотах
автотрофные: автотрофные
средний: среднем средняя средней
разрушаться: разрушаются
инфицирует: инфицирует
последний: последней
панель: панель
например: например
причем: причем
нижний: нижним нижняя
хребет: хребта
внутриклеточных: внутриклеточных
орёл: орлов
внутри: внутри
уникальный: уникальных
пример: примеров
вмешательство: вмешательство
избегать: избегает
происходить: происходят
означать: означает
биолог: биологи
дерево: дерево
извне: извне
фаза: фазах
пентозофосфатного: пентозофосфатного
липидных: липидных
скорый: скорее
иметь: имеет имели имеют
нарушение: нарушение нарушения
запускающих: запускающих
бакуловирусах: бакуловирусах
заражать: заражает заражают
зачастую: зачастую
механизм: механизмы
значение: значение
приспособлен: приспособлен
некоторые: некоторые
олигонуклеотидов: олигонуклеотидов
связывание: связывания
несущий: несущих несущий несущей
метан: метан
способный: способны
помимо: помимо
передача: передачу
высокий: высоком высший высокий
представление: представление
вещество: веществ вещества
быстрый: быструю
помогать: помогают
населять: населяет
описанный: описан описана описанных
пропускающие: пропускающие
ввоз: ввоза
время: временем
сша: сша
паттерн: паттерн
ниша: нишей
маленький: малы
сторона: стороны
английски: английски
поиск: поиск
моллюск: моллюсков моллюска моллюсках
горячий: горячих
апоптоз: апоптоз
опухоль: опухолями
нуклеоплазмы: нуклеоплазмы
существ: существ
митохондрий: митохондрий
инфекция: инфекции инфекциями
закономерный: закономерно
хроматином: хроматином
апоптоза: апоптоза
гетеротрофным: гетеротрофным
синить: синим
соответствующий: соответствующие
муцин: муцин
патогенов: патогенов
клетка: клеток клетки клетка
эндонуклеобактера: эндонуклеобактера
культивировать: культивировать
интенсивный: интенсивного
структура: структуры
весь: всей
лежать: лежит
список: список
локализация: локализацию
распределены: распределены
нетрудный: нетрудно
протеомы: протеомы
масса: массой
схожий: схожие
флуоресцентной: флуоресцентной
паразит: паразиты паразитов паразитах паразита паразит паразитом паразитами
живущий: живущих живущие живущего живущая
эндоплазматического: эндоплазматического
одна: одна
метаболические: метаболические
закономерность: закономерности
вновь: вновь
органикой: органикой
отдаленные: отдаленные
частить: части
комплекс: комплексы
используется: используется
размер: размеры размерах
действуя: действуя
гамма: гамма
ближайший: ближайшие
импортироваться: импортируются
комменсалов: комменсалов
срединный: срединно
насекомое: насекомых
человек: человеком
заканчиваться: заканчивается
ожидаемо: ожидаемо
получать: получать
описать: описали
содержание: содержание
полипептидов: полипептидов
производить: производить
экзотический: экзотическим
инфицированные: инфицированные
окружающий: окружающую
буквенный: буквенные
грубый: грубое
похожий: похожая похожи
сходство: сходство
эукариотических: эукариотических
принятый: принято
жить: живут
особый: особо
вести: ведут
лазерный: лазерная
метаболизма: метаболизма
число: числе
польза: пользу
ретикулумом: ретикулумом
паразитировать: паразитирует
сигнальный: сигнальной
функционируют: функционируют
низкий: низких низкое
вместе: вместе
морфология: морфологию
ингибитор: ингибиторов ингибиторы
акватория: акватории
проходить: проходит
предстоять: предстоит
популяция: популяций
высокоточным: высокоточным
очевидный: очевидно
специфичным: специфичным
открытие: открытие
превращение: превращений
поверхность: поверхности
ход: ходе
нормальный: нормальную
произошел: произошел
соседний: соседние
обсуждаемой: обсуждаемой
происхождение: происхождение
ранний: ранняя ранней
удлиненных: удлиненных
организм: организмы
аэробный: аэробные
септированием: септированием
недостаток: недостатка
разрыв: разрывом
единый: единого
отличие: отличие
последовать: последовали
химический: химических
захватывающий: захватывающая
необычный: необычной
компонент: компоненты
научиться: научились
утрачены: утрачены
свободный: свободных
внеклеточной: внеклеточной
морской: морских морской
относиться: относятся
митилиды: митилиды
непростой: непростая
реснички: реснички
односторонний: одностороннюю
вызванный: вызвана
повреждение: повреждения
статья: статьи статья
вызывать: вызывают
факультативно: факультативно
избирательный: избирательно
общий: общих
экологический: экологической
наружу: наружу
бактериальный: бактериального
интронов: интронов
оболочка: оболочка
испытывать: испытывают
экспрессирует: экспрессирует
больший: большая большее
публикация: публикации
перенос: перенос переноса
представляющих: представляющих
специфический: специфические
удалось: удалось
обеспечивающие: обеспечивающие
эпителиальных: эпителиальных
аминокислота: аминокислотах аминокислот
кодирующие: кодирующие
впервые: впервые
эндонуклеобактер: эндонуклеобактер
газ: газов
оказывать: оказывает
днказы: днказы
подавлять: подавляют
который: которое которую
отдельный: отдельных
условие: условиях
разрешение: разрешении
вода: воде вод
обозначены: обозначены
обозначение: обозначения
нехарактерны: нехарактерны
представлять: представляют
ткань: ткани тканей тканям
образ: образ образом
разрываться: разрывается
белка: белка белки
неожиданный: неожиданно
симбионтов: симбионтов
патогены: патогены
коралл: кораллов
температура: температур
основание: оснований
следующий: следующий
подходить: подходит
называть: называют
нехарактерные: нехарактерные
построено: построено
рост: роста
хемоорганотрофным: хемоорганотрофным
эубактериальных: эубактериальных
микоплазмы: микоплазмы
первый: первые первая
видовой: видовыми
эндонуклеобактеры: эндонуклеобактеры
фосфотрансферазной: фосфотрансферазной
специализироваться: специализируется
мочь: могли
кислота: кислотами кислоту
действие: действие
вид: виде видов вида
синий: синий
изображение: изображение изображения
пополнить: пополнила
место: мест
предполагать: предполагает
краситель: красителем красители
мелкий: мелких
лишённый: лишена лишены
полученные: полученные
деление: деления
двустворчатый: двустворчатых
метагеномный: метагеномный
мидия: мидии мидий
капля: капель
иммунный: иммунного
численность: численности
животное: животные животных животного животными
электронный: электронного
случай: случаях
гликопротеин: гликопротеины
поскольку: поскольку
случать: случай
анализ: анализ
монофилетическое: монофилетическое
питаться: питаются
импортеры: импортеры
днк: днк
опосредованный: опосредованный
цикл: цикл цикла
пар: пар паре
ответ: ответа ответ
соответственный: соответственно
показывать: показывают
конец: конце конец
нарушаться: нарушается
хитиназ: хитиназ
понять: понять
помощь: помощью помощи
изменение: изменениями
перестает: перестает
обитать: обитают
погибнуть: погиб
сохранять: сохраняет
связанный: связанный
ряд: ряд
брюхоногие: брюхоногих
такой: таких такому таким такого такую
биосинтез: биосинтезе
переносить: переносит
экспрессия: экспрессии экспрессию
остается: остается
донор: донорами
внутриядерный: внутриядерной
эпитет: эпитетами
родственник: родственники
использование: использованием
тысяча: тысячи
хитиназу: хитиназу
заражающего: заражающего
часть: частях
инфекционный: инфекционный
попасть: попасть
ядро: ядра ядре ядро ядер
поражать: поражает
ранее: ранее
настолько: настолько
вооружение: вооружений
синтез: синтеза
нуклеиновую: нуклеиновую
задача: задача
желтый: желтый
выяснить: выяснили выяснить
секвенировали: секвенировали
импорт: импорта
разрушать: разрушает разрушают
протистов: протистов
использовать: использовать использует
цитоплазме: цитоплазме
смерть: смерть
собрать: собрали
успев: успев
сахар: сахарах сахаров сахара
совершенный: совершенно
отслеживали: отслеживали
проникновение: проникновения
кда: кда
уровень: уровни уровень
активный: активно активны
найти: нашли
сипов: сипов
значительный: значительные
выходить: выходят выходит
гомологичные: гомологичные
самый: самые самых
развитие: развития
делать: делает
эндоплазматическим: эндоплазматическим
делиться: делятся делится
кребса: кребса
серый: серо
органелл: органелл
вопрос: вопрос
экспорт: экспорта
рамка: рамках
программируемую: программируемую
атлантический: атлантического
взаимодействие: взаимодействие
универсальность: универсальностью
многие: многие многих
транскриптомы: транскриптомы
внутрь: внутрь
генетический: генетическое
охарактеризованы: охарактеризованы
область: область
справедливый: справедливо
различие: различия
источник: источник
внутриклеточные: внутриклеточные
среда: среде среду
метаболитов: метаболитов
разрушение: разрушения
друг: друг другу
оказаться: оказались оказалось
различаться: различалось
процесс: процессе
окрашенной: окрашенной
зависимость: зависимости
крупный: крупные
лабораторный: лабораторной
органеллы: органеллы
работа: работа работе
эукариотической: эукариотической
зависеть: зависит
давать: дают
мешать: мешает
клеточный: клеточном клеточную
рнк: рнк
гипотеза: гипотеза
кодируемые: кодируемые
догадаться: догадаться
глубоководный: глубоководных
маркерных: маркерных
предложена: предложена
поровые: поровые
каспазы: каспазы
целый: целые целых
считать: считают считали считать
отметить: отметили
буквальный: буквально
экскретируют: экскретируют
метаболизм: метаболизм
необходимый: необходимы необходимые необходима
муцины: муцины
культура: культуры
анаэробные: анаэробные
ученых: ученых
ресничек: ресничек
консервативный: консервативных консервативные
последовательность: последовательности
домашний: домашнего
семейство: семейства семейству
исследованный: исследованы
база: баз
жаберный: жаберной жаберные жаберным
микроскоп: микроскопа
повторение: повторений
метаболиты: метаболиты
ведется: ведется
расплодиться: расплодиться
ацетилглюкозамина: ацетилглюкозамина
борьба: борьбу борьба
двустворок: двустворок
основа: основе
использованный: использованная
секвенированием: секвенированием
видимый: видимому
предок: предка
михаил: михаил
край: край
пилотаж: пилотаж
представитель: представители
эндонуклеобактеров: эндонуклеобактеров
герпеса: герпеса
обе: обе
новый: новой новая новым новые
растущий: растущий
исключительный: исключительно
симбионтами: симбионтами
исследователь: исследователи
факторов: факторов
обнаружить: обнаружили
имеющийся: имеющиеся
микроворсинок: микроворсинок
сравнительный: сравнительно сравнительное
интересный: интересные
увеличиваться: увеличиваются увеличивается
германий: германии
выход: выхода выходом
счет: счет
сероокисляющие: сероокисляющие
фермент: фермент ферментами ферменты ферментов
наличие: наличию наличие
хозяйство: хозяйства
однообразие: однообразие
