излучение: излучения
особый: особые особый
несущий: несущую
использованный: использованных использован
медведь: медведь
лишайник: лишайниках
кислород: кислорода
сухой: суше сухой
ген: генов
черных: черных
вернуться: вернуться
семейство: семейства
крошечный: крошечные
специфичные: специфичные
показана: показана
культивируемым: культивируемым
предсказывать: предсказывать
беспорядок: беспорядка
другой: другими
несет: несет
пресный: пресных
заинтересоваться: заинтересовались
выполненные: выполненные
обе: обе
большинство: большинство большинстве
нескольких: нескольких
рана: ран
черные: черные
предсказана: предсказана
модель: модель
длина: длину длина
клетка: клетки клеткам
очертание: очертания
ядро: ядро
предсказаны: предсказаны
неупорядоченными: неупорядоченными
закрывать: закрывает
основа: основе
общий: общие общую
случайный: случайный
пример: примере
круговой: кругового круговой
блок: блоки
клеточный: клеточные
лишен: лишен
первичный: первичной
справа: справа
глобула: глобула
рентгеноструктурного: рентгеноструктурного
тело: тело тела
английски: английски
электростатические: электростатические
изученного: изученного
компактный: компактную
приобретение: приобретение
смочь: смогли
фундаментальный: фундаментальные фундаментальной
механизм: механизмы механизмах
строгий: строго
михаил: михаил
оказаться: оказался оказалось
истязание: истязания
конформацию: конформацию
водный: водный
развиваться: развиваться
биоинформатиков: биоинформатиков
стабильность: стабильность
гидрофобность: гидрофобность
натрий: натрий
вытянутый: вытянутым
белок: белком
статья: статье статьи статья
специфический: специфические специфических специфической
конформация: конформация
алгоритм: алгоритмов
неупорядоченный: неупорядоченный
ибп: ибп
отдельный: отдельных отдельные отдельно
контактирует: контактирует
биофизический: биофизические
главное: главным главные
соединение: соединениями
трансгенного: трансгенного
ученые: ученые
содержать: содержит
свойство: свойства
локализация: локализации
чрезвычайный: чрезвычайно
переход: переход
тихоходок: тихоходок
английский: английском
гибкий: гибкими гибок
подтвердить: подтвердили
неупорядоченного: неупорядоченного
служить: служит
рис: рис
различие: различие
гидрофилен: гидрофилен
сойтись: сошлись
нарушающих: нарушающих
жидкостный: жидкостному
раствор: растворах растворе
получить: получили
обладатель: обладатель
зачастую: зачастую
нагрев: нагрев
попасть: попасть
конформацией: конформацией
предрасплавленная: предрасплавленная
частичный: частично
упорядоченные: упорядоченные
описать: описали описало
рнк: рнк
регион: регионы
отнести: отнесли
мушка: мушке
полоса: полосами
упорядоченными: упорядоченными
белковый: белков белковых
аминокислота: аминокислот аминокислоты
потрясающий: потрясающей
неупорядоченной: неупорядоченной
набор: наборе набора
среди: среди
сустав: суставов
ряд: ряд
содержание: содержание
тонкий: тонкая
тау: тау
присутствие: присутствии
глубина: глубине
высасывая: высасывая
множество: множества множество
снижать: снижают
биология: биологии
молярной: молярной
пропорция: пропорции
весть: вести
выдерживать: выдерживают
табак: табаку
курильщик: курильщиков
вызвать: вызвал
процесс: процессы
черная: черная
короткий: коротких короткие
мера: мера
подыскать: подыскала
больший: большую большей большие
живучий: живучих
подробнее: подробнее
плазмид: плазмид
придать: придать
настоящий: настоящему
счет: счет
способный: способны
лежать: лежат
рентгеновский: рентгеновское
ранжированы: ранжированы
капля: капель
видимый: видимому
высокий: высокие высокий выше высоко
низкий: низкие
ответить: ответят
метода: методы метод
цитоплазме: цитоплазме
неупорядоченным: неупорядоченным
связывать: связывают связывать связывает
подход: подход
пониженный: пониженную
неупорядоченных: неупорядоченных
давление: давление
полученный: полученный
конформаций: конформаций
распределение: распределение распределения
электростатических: электростатических
подчас: подчас
слева: слева
биологический: биологические
линия: линия
живой: живых
останавливать: останавливают
нуклеиновые: нуклеиновые
фосфорилированием: фосфорилированием
упорядоченный: упорядоченный
необходимый: необходимых
тихоходкам: тихоходкам
трехмерная: трехмерная
отличие: отличия
доза: дозы
толстый: толстых толстая
строение: строением
метаболические: метаболические
минута: минут
понимание: понимания
новый: новой новая новую
выделяться: выделяются
такой: таких
жизнь: жизни
водоемах: водоемах
подтвержденных: подтвержденных
читать: читайте
ион: ионов
рекордный: рекордную
адаптация: адаптации
мелкий: мелкими
связано: связано
внутренний: внутренне внутренней
который: которую
открытый: открыт
организм: организмов организм организмах
демонстрирующие: демонстрирующие
неблагоприятных: неблагоприятных
приобретать: приобретают
терять: теряют
стабильный: стабильной
фаза: фаз
радиация: радиации радиацией
существ: существ
выполнять: выполнять
свернутый: свернутый
лиловый: лиловая
бета: бета
изучение: изучению
медицина: медицине
размер: размерами размер
специализированные: специализированные
отличаться: отличаются
взаиморасположением: взаиморасположением
позволять: позволяет
ансамблевая: ансамблевая
сайт: сайта сайтов сайты сайтами
частить: части
улитка: улитка
участок: участками
посттрансляционными: посттрансляционными
медвежонок: медвежонка
заостренного: заостренного
помогать: помогают
существовать: существуют
посттрансляционных: посттрансляционных
столбик: столбики
полученная: полученная
постоянный: постоянной постоянно
жизнедеятельность: жизнедеятельности
окислительный: окислительному
тип: тип типа
ядерный: ядерных ядерной
относиться: относятся
вероятный: вероятно
придает: придает
обитый: обитая
фосфорилирование: фосфорилирование
онихофорам: онихофорам
язык: языках
часть: частей частью часть частями
подобный: подобный подобно
введение: введения
животное: животных животные животными животное
почва: почве
ожидаемо: ожидаемо
назвать: назвать
гидрофобности: гидрофобности
стабильнее: стабильнее
фосфорилирования: фосфорилирования
продолжать: продолжает
различный: различным различные различных различной
ионизирующей: ионизирующей
растворить: растворим
нарушать: нарушают
порог: порог
приспособленными: приспособленными
растворимость: растворимость
расплавленная: расплавленная
исследователь: исследователи
освоить: освоили
спектроскопия: спектроскопию спектроскопии
вертикальный: вертикальными
ширина: ширине
неупорядоченные: неупорядоченные
название: названии названия
ранее: ранее
рассчитанный: рассчитана
радиус: радиус радиуса
равный: равен
описанный: описаны
температура: температуры
оияи: оияи
химический: химической
расположенный: расположены
менять: меняет
неплотный: неплотно
запланированные: запланированные
обнаружить: обнаружили
мешать: мешает
приписать: приписать
дубна: дубна
единственный: единственный
склонность: склонности склонность
слой: слои
реагент: реагент
мох: мхах
течение: течение
митохондриях: митохондриях
объект: объектами
практический: практического
потенциальный: потенциальных
повышенный: повышенную
спираль: спиралей
факторов: факторов
укорочение: укорочение
орёл: орлов
глубокий: глубокого
отрицательный: отрицательных отрицательные
вторичный: вторичной
стимулирующий: стимулирующий
динамика: динамики
направленный: направленного
стандартный: стандартном
моделирование: моделирование
предполагаемый: предполагаемые
рентгеноструктурный: рентгеноструктурный
примерно: примерно
взаимодействие: взаимодействия
миллиметр: миллиметра
последовательность: последовательностью последовательность последовательности
дно: дне
рачки: рачки
населяющие: населяющие
повреждение: повреждения
долить: долей
трифторэтанол: трифторэтанол
необычный: необычному необычные
микроскопический: микроскопического
разновидность: разновидности
молекулярный: молекулярные молекулярном молекулярной молекулярное
опубликованной: опубликованной
сказать: скажем
долгий: долгие
упорядоченную: упорядоченную
указывать: указывают
самый: самых самые
экстремальным: экстремальным
лишенной: лишенной
мономеров: мономеров
уровень: уровень уровне
гидрофильными: гидрофильными
способность: способность
означать: означают означает
сигнал: сигнал
альцгеймера: альцгеймера
форма: форм форму форма формой
комплекс: комплекс комплекса
видеть: видит
увеличивать: увеличивает
нечеткую: нечеткую
восьми: восьми
неупорядоченную: неупорядоченную
делать: делают
синий: синий синяя
связывающего: связывающего
опасный: опасных
выход: выхода
клубок: клубок
ортолог: ортолог
меньший: меньшей
образование: образование
вопрос: вопросы
переходить: переходят
сок: сок
кислота: кислотой кислоты
являться: является являются
конечность: конечностей
называемые: называемые
представитель: представители представителя
растение: растениями
дальний: далее
удалось: удалось
полученной: полученной
неспецифичные: неспецифичные
замораживание: замораживание
присутствовать: присутствуют
околоземный: околоземной
образ: образом
генерируемых: генерируемых
точный: точно точные
плодовый: плодовой
океанический: океанических
стать: стали
определяться: определяется
многие: многое многих многие
белка: белки белка белку белок белке
походка: походка
ионизирующего: ионизирующего
дихроизма: дихроизма
согласный: согласно
график: график
пик: пика
условие: условиях условии
активный: активных
понять: понять
обычный: обычных
автор: авторы
подавляющий: подавляющий
афк: афк
биофизик: биофизики
элемент: элементы
железный: железная
конкретный: конкретной конкретными
средний: средняя
формируются: формируются
малоугловое: малоугловое
упорядоченная: упорядоченная
розовый: розовая
показать: показал
усредненная: усредненная
малочисленный: малочисленный
фиксированную: фиксированную
палочковидным: палочковидным
регулироваться: регулироваться
среда: среды среду среде
локализованные: локализованные
центр: центра центре
кипячение: кипячения
лидировать: лидирует
положительный: положительный положительные
лишённый: лишены
гидрофобная: гидрофобная
уникальный: уникальных уникальные уникальным уникальный
высыхание: высыхание
будущий: будущем
описывать: описывают
дубне: дубне
вакуум: вакуума
перспективный: перспективны
премия: премию премия
килодальтона: килодальтона
показан: показан
фосфатном: фосфатном
устойчивость: устойчивость устойчивости
соленые: соленые
действие: действию
внеклеточные: внеклеточные
концевой: концевые
база: базы
оптимизация: оптимизации оптимизация
узнавание: узнавания
небольшой: небольших небольшого
изменчивый: изменчив
человек: человека
заданный: заданным заданную заданной
состоящих: состоящих
трехмерных: трехмерных
кульминация: кульминацией
неупорядоченная: неупорядоченная
популярность: популярность
ротовой: ротового
заряд: заряд зарядов заряда
экспериментальный: экспериментальный экспериментально
вывод: выводы
перспектива: перспективы
страшный: страшно
рабочий: рабочем
эффект: эффект
дальнейший: дальнейшие
приобрести: приобрели
значение: значения значений
поставлять: поставлять
деионизированной: деионизированной
предпосылка: предпосылки
иначе: иначе
рассеяние: рассеяние
реконструированная: реконструированная
структура: структуру структуры структурой структур структуре структура
сохраняющих: сохраняющих
использовать: использовали использовала
питаться: питается
временный: временно
использование: использования использованием
предсказать: предсказали
близкий: близкий близки близкой близком
живучесть: живучести
разделение: разделению
ангидробиоз: ангидробиоз
зеленая: зеленая
стресс: стрессу стресса
оценка: оценкам оценка оценкой оценке
дробь: дробь
вид: виде видов
опыт: опытов
порядок: порядке
регулировать: регулировать
фибриллы: фибриллы
благодаря: благодаря
буквальный: буквально
анализ: анализа анализ
оценить: оценили оценить
новость: новость
ансамбль: ансамбля
время: времена
благоприятный: благоприятную
четко: четко
известный: известный известно
состоять: состоит
воздействие: воздействиям воздействия
обитатель: обитатель
расширенный: расширенную
биотехнологии: биотехнологии
число: числе
функция: функции
покой: покоя
день: дней
перейти: перейти
программа: программа программ программы
буфер: буфере
установленный: установлены
членистоногим: членистоногим
облик: облику облик
неупорядоченностью: неупорядоченностью
явление: явлении
бимодально: бимодально
способ: способ
гибкость: гибкости
пять: пяти
пунктирный: пунктирная
ангстремам: ангстремам
градус: градусов
сравнение: сравнения
балл: баллами
мочевина: мочевины
защищать: защищать защищает
доля: долю
разуметься: разумеется
подписаны: подписаны
проанализировать: проанализировали
имеющий: имеющими имеющим
мфти: мфти
большой: большой
пар: пару
изменение: изменениями
абсолютный: абсолютному
сравнительный: сравнительно
нуклеиновой: нуклеиновой
сильный: сильнее сильный
платформа: платформы
считать: считают
молекула: молекулы молекул молекула молекуле
химия: химии
космический: космического космической
размножаться: размножались размножаться
стабилизирующих: стабилизирующих
случай: случае
серый: серым
сегмент: сегментов
ничто: ничто
аминокислотный: аминокислотных аминокислотную аминокислотным аминокислотный аминокислотные
модификация: модификаций модификации
альфа: альфа
денатурирующий: денатурирующий
агент: агент
эксперимент: эксперименты экспериментам
тяжелые: тяжелые
секреторный: секреторные
красный: красные красный красная красным
неспешный: неспешная
артемии: артемии
успешный: успешно
класс: класса
отмечены: отмечены
данные: данных данные данным
соответствовать: соответствуют
фото: фото
нуль: нулю
вода: воды воду вод воде
функционирует: функционирует
масса: массе
уверенно: уверенно
огромный: огромные
состояние: состоянии состояние состояния
помощь: помощью
аппарат: аппарата
суммарный: суммарный
конец: конец
детальный: детального
тихоходки: тихоходки
днк: днк
ангидробиоза: ангидробиоза
поскольку: поскольку
работа: работы работе
коллега: коллеги
пущино: пущино
присудить: присудили
упорядоченность: упорядоченностью
факторам: факторам
экстремофильными: экстремофильными
природа: природы
транспорт: транспорта
неупорядоченности: неупорядоченности
вступать: вступает вступают
смесь: смеси
неблагоприятным: неблагоприятным
отражено: отражено
ученых: ученых
сперва: сперва
ансамблевой: ансамблевой
тихоходка: тихоходка
фиксированной: фиксированной
бледный: бледно
дихроизм: дихроизм
выживать: выживали
нобелевский: нобелевскую нобелевская
характерный: характерно характерный
одни: одни
немецкий: немецком
остаток: остатков остатках остатки остаткам остатка
оранжевый: оранжевыми
уверского: уверского
зеленый: зеленый
сегментированное: сегментированное
море: морях
фосфатов: фосфатов
область: область области областях
фосфата: фосфата
желтая: желтая
ангстрем: ангстрем
информация: информацию
исследование: исследований
орбита: орбите
болезнь: болезни
помимо: помимо
рассчитываться: рассчитывается
втягивать: втягивают
состав: состав составе
массы: массы
негативный: негативных
журнал: журнале
разный: разные разных разными
иметь: имеют имеет имел
переждать: переждать
доменов: доменов
изображение: изображение
каждый: каждого каждом
оси: оси
лёгкий: легко
устойчивый: устойчивых
наблюдать: наблюдать
составить: составила
объяснять: объясняют
бочонок: бочонка
полностью: полностью
обсуждаемой: обсуждаемой
данный: данной
иллюстрировать: иллюстрирует
инерция: инерции
упорядоченное: упорядоченное
нормальный: нормальную нормальной
поприще: поприще
результат: результаты
объесть: объем
щит: щитом
объединенного: объединенного
лиганды: лиганды
поэтому: поэтому
переносить: переносят
присоединение: присоединении
рисунок: рисунок
выглядеть: выглядел
источник: источник
голод: голод
ножка: ножки
профиль: профиль
потеря: потерей
выносить: выносят
подвергаться: подвергались
соответствующий: соответствующих соответствующем соответствующего
связываться: связывается связываются
рассмотреть: рассмотрели
наука: науки
вырост: выроста
жёлоб: желобов
