фото: фото
посвященным: посвященным
руководство: руководством
статистический: статистического
грудной: грудное грудного
различие: различиях
идущий: идущий
проблемный: проблемным
австралопитеков: австралопитеков
перестройка: перестройки
материнский: материнской
горизонтальный: горизонтальной
отражающих: отражающих
справляться: справляться
видеть: видят
сравнивать: сравнивали
составить: составили
нарушаться: нарушается
химический: химического
трудный: трудно
здоровый: здоровыми
коренной: коренных
высокий: высокому выше
несостыковок: несостыковок
четко: четко
вывод: выводами
весьма: весьма
музейный: музейной
прикинуть: прикинуть
регистрироваться: регистрировалась
несколькими: несколькими
раз: раза
ребёнок: детей дети
датированные: датированные
выяснить: выяснить
гипопластическими: гипопластическими
период: периоды период периода
положение: положению
елена: елена
использованный: использованного
расти: росли расти
болезнь: болезни
жизнь: жизни
средний: среднему среднем
снижаться: снижается
сказать: скажем
стоянка: стоянок
переход: переходе переход перехода
отложение: отложения
целый: целом
момент: момент
соотнесение: соотнесение
влияние: влияния
интересный: интересна
специфический: специфические
край: краю
составлена: составлена
использование: использованию
определенную: определенную
соответствующий: соответствующих соответствующие
эволюционный: эволюционный
сразу: сразу
понятный: понятно
неандертальский: неандертальские неандертальских неандертальского
который: котором
анализ: анализа
элемент: элементы
пережитого: пережитого
оставить: оставили
жившего: жившего
многие: многих
вскармливание: вскармливание вскармливания
журнал: журнал
голод: голод
статья: статьи
отнятие: отнятие отнятия
антрополог: антропологи антропологов
материал: материала
прежде: прежде
сохранившихся: сохранившихся
популяция: популяции
представлять: представляет
сапиенсов: сапиенсов
называемая: называемая
линейный: линейная линейных
тюбингена: тюбингена
иметься: имеется
оказываться: оказываются
дефект: дефекты дефектами дефектов дефект
сапиенсам: сапиенсам
единообразный: единообразную
оси: оси
полугодовалый: полугодовалом
отложены: отложены
примерно: примерно
пятеро: пятеро
провести: провели
индивид: индивидов индивида
индивидуальный: индивидуальный индивидуального
грудь: груди
вместо: вместо
полтора: полтора
сапиенсы: сапиенсы
негативный: негативные
иной: иной
ленточный: ленточная
обстоятельный: обстоятельную
применить: применить
постоянный: постоянно постоянные постоянных
соотношение: соотношений
кормить: кормили кормить
верхний: верхнему
показать: показали
премолярах: премолярах
неблагоприятный: неблагоприятный
максимальный: максимальные
взрослый: взрослую
картина: картина
точный: точных точным точно
соответствовать: соответствует
физиологические: физиологические
такой: таким
специальный: специальную
отдельный: отдельному
обычный: обычные
каковой: какова
одну: одну
утонченной: утонченной
определение: определение
свидетельство: свидетельством
полезнее: полезнее
исследователь: исследователям
прежними: прежними
отношение: отношениях
поэтому: поэтому
пищать: пищу
холод: холод
интервал: интервала интервалы
выполнение: выполнения
организм: организме организма организму
твердую: твердую
представить: представили
сбиваться: сбивается
образ: образом
сайт: сайта
нелёгкий: нелегко
фактически: фактически
успех: успеха успех
ребенок: ребенок
обоим: обоим
график: график
должный: должна
изучить: изучили
относящихся: относящихся
одновременный: одновременно
выделять: выделяют
видимый: видимому видимо
этап: этапы
малыш: малыши малышах малышам малышей
заподозрить: заподозрить
отличие: отличие отличия
тип: типу типов
молярах: молярах
автор: авторы
европа: европы
находить: находят
понадобиться: понадобились
обмен: обмен
треть: треть трети
проблема: проблемами
одинаковый: одинаковым
склоняться: склоняются
детский: детского детском детскому
столь: столь
нашего: нашего
основанный: основанную
пятнистый: пятнистая
считать: считают
эль: эль
совпадать: совпадает
принцип: принципе
динамика: динамика
удалось: удалось
ширококостными: ширококостными
коренастый: коренастыми
физиологического: физиологического
глубокий: глубокими
эмаль: эмали эмаль
степень: степени
ревностный: ревностной
кольцо: колец
отнимать: отнимают
сравнить: сравнили
работа: работа работу
широта: широтой
нарушение: нарушениями
видный: видны
расчеты: расчеты
рассудить: рассудили
самостоятельный: самостоятельно
решив: решив
естественный: естественно
растущего: растущего
продолжаться: продолжалось
переживаться: переживается
последствие: последствия
следовать: следует
стресс: стресса стрессе стресс стрессу
родительский: родительского
состав: состав
временный: временного
череп: черепа
ожидаемо: ожидаемо
знакомить: знакомит
обоих: обоих
формируются: формируются
развитой: развита
другой: другого
наймарк: наймарк
ученые: ученые
неблагополучный: неблагополучные
сглаживать: сглаживали
процесс: процесс процессы
сирин: сирин
сапиентных: сапиентных
повышение: повышение
информация: информация
критический: критического
нескольких: нескольких
набор: набору набор
молоко: молоком молока
заканчиваться: заканчивалось
причина: причин причину
гипоплазия: гипоплазия
заатари: заатари
принадлежность: принадлежности
стадия: стадии стадия стадий стадиях
помощь: помощью
человек: людей
готовый: готовы
полноценный: полноценному
продолжительный: продолжительный
возрастной: возрастная
полутора: полутора
получиться: получилось
линия: линий
коллекция: коллекцией коллекции
отмечать: отмечают
гипоплазии: гипоплазии
общий: общий общая
общество: обществах
признак: признаков
силен: силен
использовать: используют использовать
резец: резцах
маркирующая: маркирующая
повышенный: повышен
источник: источник
рождаться: рождались
возраст: возраста возраст возрастом возрасту возрасте
находка: находки
зуб: зубов зубах зуба зубы зубе зубами зуб
появляться: появляются появляется
обеспечить: обеспечить
маленькая: маленьких
вид: вида видов виде видам
университет: университета
оценка: оценками
таблица: таблицу
ребенка: ребенка
современный: современных
плохой: хуже
читатель: читателей
параллельный: параллельных
нарастание: нарастания
переставать: переставали
идет: идет
неандертальцев: неандертальцев
проявление: проявление
варьировать: варьируют
выборка: выборка
молочный: молочные молочный
маркировать: маркируют
методика: методикой методику
окончание: окончания
проявляться: проявляться
сформирована: сформирована
доставаться: доставалось
видовой: видовое
информативен: информативен
проявиться: проявилась
отобрать: отобрали
результат: результатам результате
внимание: внимания
пищевой: пищевом
каждый: каждому каждом каждой
полоса: полоса полосы
весь: всей
резкий: резко
новый: новое новым новая новыми
продолжать: продолжали продолжает
взять: взять
доля: доля доли
обсуждаемой: обсуждаемой
широкий: широко
субтильный: субтильных
возможный: возможных
предположить: предположили
большой: наибольший
прикармливать: прикармливать
некоторые: некоторые
побольше: побольше
надежным: надежным
древние: древних
забота: заботой заботы
столько: столько
первый: первых первая
задача: задачи
иметь: имеют
оказаться: оказаться оказалось
трудность: трудность
физиологический: физиологический
палеолит: палеолитом палеолиту
взросления: взросления
данные: данные
белковый: белковый
воспользоваться: воспользовались
отчасти: отчасти
ухудшаться: ухудшалось
дать: дало
занимательный: занимательного
сдвинуты: сдвинуты
заботиться: заботились заботиться
пятно: пятен
гипопластических: гипопластических
второй: вторая
определить: определили
грудью: грудью
проявлять: проявляли
исследование: исследование исследованием исследовании
уровень: уровень
зубной: зубной
мама: мамы
пораженных: пораженных
начинать: начинали
приходиться: приходилось
предполагать: предполагают
здоровье: здоровье
слепок: слепков слепках
развитие: развития
третий: третья
клык: клыках
отражаться: отражалось
данный: данная данный данном
формирование: формирования
проясниться: прояснится
сумма: сумме
значение: значения
неандерталки: неандерталки
следующий: следующих
выясняться: выясняется
неандертальцам: неандертальцам
оценить: оценить
показатель: показатель показателем показателей
испытывать: испытывает испытывали
разнородный: разнородны
