плодородный: плодородного
российский: российских
тысячелетие: тысячелетия
поселение: поселения
видный: видно видна
человечество: человечества
сократиться: сократилась
доместикации: доместикации
обсуждаемой: обсуждаемой
тур: туров
повсюду: повсюду
группа: группа групп группой группы
влиять: влияют
представлять: представляет
сравнение: сравнению
небольшой: небольших
новый: новый новая нового
преуспеть: преуспели
климатический: климатическими
неодолимый: неодолимой
свой: своим своими
поэтому: поэтому
особый: особый
палеогенетиков: палеогенетиков
хромосома: хромосомах хромосоме
сам: самое
подвид: подвид подвиды
проследить: проследить
родственник: родственников
зависимость: зависимость
вносить: вносят
конкурент: конкуренты
лесной: лесным
появиться: появился
экологический: экологическая
желтый: желтый
немногий: немногих
разнообразие: разнообразие
территория: территории территорию
оказаться: оказались
родоначальник: родоначальники
анатолии: анатолии
длина: длине
зеленый: зеленый
изначальный: изначально
судя: судя
мтднк: мтднк
облик: облик
распространиться: распространилась
прирученных: прирученных
центральноазиатская: центральноазиатская
местный: местных
безусловный: безусловна
образ: образом образ
колоссальный: колоссальные
возможность: возможностью
частность: частности
верхний: верхних
число: число
леванта: леванта
коренной: коренным
азия: азии азию
синхронный: синхронными
распространить: распространила
близкородственный: близкородственного
журнал: журнале
биомасса: биомассу
использованный: использованы
археологический: археологические
дать: дали дала
получать: получали
анализ: анализа
собрать: собрала
основа: основе
дублин: дублине
нечастый: нечасто
восток: восток востока
одомашненного: одомашненного
постепенный: постепенно постепенным
холодный: холодного
мутация: мутации
численность: численность численности
использоваться: использоваться
диапазон: диапазоне
безгорбого: безгорбого
практически: практически
прослеживается: прослеживается
колонна: колонне колоннах
полумесяц: полумесяца
европейский: европейская европейской европейских европейские
параллельный: параллельно
елена: елена
возраст: возраст возрасту
изменить: изменило изменила изменили
чикурова: чикурова
признак: признаков
фермер: фермеры
южный: южной южно
этнографии: этнографии
прерваться: прервалась
согласоваться: согласуются
единичный: единичных
примерно: примерно
трех: трех
горбатый: горбатый
попав: попав
гомозиготных: гомозиготных
прирученный: прирученный
западный: западной
послушный: послушную
восточный: восточной
приручение: приручения
очевидный: очевидна очевидно
индийский: индийская индийские индийской индийского индийских
центральный: центральной
африка: африку
набор: наборами
география: географии география
археология: археологии
слагаемое: слагаемые
особенность: особенностям
современный: современный
идентичность: идентичность
непростой: непросто
восточноазиатского: восточноазиатского
означать: означает
пошлый: пошло
тема: темы
понятный: понятно
голова: головы
показаны: показаны
университет: университетов
напротив: напротив
доледниковое: доледниковое
исходный: исходно
корова: коров коровы корову коровами
подобный: подобные
северный: северную
британский: британских
вместе: вместе
луговым: луговым
букрании: букрании
дэниэла: дэниэла
физиология: физиология
дикий: диких дикие
кружочек: кружочки кружочках
хозяйствование: хозяйствования
картина: картину
десятилетие: десятилетие
обширный: обширные
ученых: ученых
отличаться: отличались
приобретать: приобретать
потомство: потомству потомство
бык: быков
резкий: резко
сокращение: сокращение
днк: днк
выиграть: выиграл
ритуальный: ритуальных
накопление: накопления
руководство: руководством
остальное: остальных
огромный: огромным
изображение: изображение
крупный: крупный крупного крупных крупные
млрд: млрд
фигурка: фигурки
независимый: независимо
приспособлены: приспособлены
зависеть: зависел
расселяться: расселяться
скот: скот скота скоту
доместикацию: доместикацию
реконструируя: реконструируя
сравнительный: сравнительно
домашний: домашний домашнему домашнего
популяция: популяциями популяции популяция популяций популяциях
формируется: формируется
опубликована: опубликована
дискутируется: дискутируется
вид: вид виды
присутствие: присутствию
фото: фото
достигнуть: достигли
гуюк: гуюк
заключать: заключают
пережившие: пережившие
европа: европы
давшие: давшие
крс: крс
чатал: чатал
происходить: происходило происходили происходила
связь: связь
исследование: исследование исследовании
преграда: преградой
древний: древнего
четырех: четырех
выявляться: выявляется
агрессивный: агрессивного
обнаруживаться: обнаруживается
обстоятельство: обстоятельствами
рог: рогами
последний: последнее
колледж: колледжа
близкий: близких
изображать: изображали
содержание: содержание
никакой: никаких
линия: линии
реконструировать: реконструировала
массовый: массовый
смысл: смысле
основанный: основанная
ген: генов гены
знать: знали
охотиться: охотились
датированы: датированы
монотонный: монотонных
турция: турции
прародитель: прародителей прародителем
стадо: стада стадам
ниша: ниша
источник: источник
ледниковый: ледникового
скрещиваться: скрещивался
разведение: разведении
пастбище: пастбищ
стилизованный: стилизованные
армения: армении
привнос: привнос
вырезать: вырезали
потихоньку: потихоньку
локальный: локальными
вывод: выводу
участие: участия участии
смешение: смешения
ход: ходе
одомашнивание: одомашнивание одомашнивания
актуальность: актуальность
следить: следили
млекопитающий: млекопитающих
тура: тура тур туры турами
маркёр: маркерам маркерами
момент: момента
событие: события событий
результат: результате
измениться: изменились изменился
синий: синий
стен: стенах
история: историю истории история
горб: горба горбом
начаться: началось начался
общий: общую
травоядный: травоядных
генетик: генетики
хозяйство: хозяйства
широкий: широком
человеческий: человеческую
демографическую: демографическую
череп: черепа
характерный: характерным
альпы: альпы
примешивались: примешивались
центральноазиатских: центральноазиатских
рогатый: рогатый рогатого
приручать: приручать приручал
доместикация: доместикация
похожий: похожи
сожитель: сожителя
большой: наибольший большой большого
исторический: исторического
приручены: приручены
оттуда: оттуда
порекомендовать: порекомендую
разный: разных
произойти: произошли
вопрос: вопрос
скрещивание: скрещивания
весь: всей
существовать: существовали
снижение: снижения
одних: одних
род: рода
согласный: согласно
немногочисленный: немногочисленные немногочисленны
ученые: ученые
единица: единицы
одомашненные: одомашненные
наследие: наследие
самый: самый
оледенение: оледенения
происхождение: происхождении
человек: человека человеком
сильный: сильного
интерес: интерес
инда: инда
нила: нила
образец: образцы образца образцах
сегрегация: сегрегации
север: север
обсуждать: обсуждаем
гомозиготности: гомозиготности
шанс: шанс
долина: долине долины
основный: основном
животное: животное животного животных
присутствовать: присутствовали
проясняться: проясняются
весьма: весьма
жизнь: жизни
короткий: короткое короткие
степень: степени
максимум: максимума
одомашненный: одомашненный
порода: породы породам
длинный: длиннее
одомашненных: одомашненных
подбор: подбором
количество: количеству
нескольких: нескольких
ядерный: ядерные
природа: природы
хищник: хищники
скорый: скорее
ландшафт: ландшафтам
леванте: леванте
повышено: повышено
видимый: видимому
вклад: вклад
наоборот: наоборот
малочисленность: малочисленность
использование: использования
диаграмма: диаграмма
прокорм: прокорм
контролируется: контролируется
журавль: журавля
ним: ним
данные: данные данных
расселение: расселения расселение
схема: схемы схема
быстрый: быстрое
подпись: подпись
планета: планеты
пользоваться: пользуются
красный: красный
примесей: примесей
суровый: суровые
считанные: считанные
неолитический: неолитического неолитическом
неолит: неолита
азиатский: азиатская
наименьший: наименьшей
этап: этапах
прочитать: прочитать прочитали
появляться: появляется появлялось
особь: особей
ареал: ареал
приручить: приручить
такой: такого такому таким таких
запад: запад запада
палеогенетические: палеогенетические
первый: первых
генетический: генетическое генетические генетическую генетическими генетическим
цивилизация: цивилизацию цивилизация
различный: различными
известный: известно
выделяться: выделяется
карта: картах
ясный: ясно
демография: демография
евразия: евразию евразии
специалист: специалистов
вовлеченные: вовлеченные
маленькая: маленькие
домашние: домашних домашними
международный: международная
пещера: пещер
динамический: динамическая
передается: передается
период: периода
практиковать: практиковали
участок: участков
сделать: сделать
спариваясь: спариваясь
деталь: детали
рисунок: рисунок
лиса: лисы
отдельный: отдельная отдельный
материнский: материнской
помалу: помалу
система: система
составлять: составляет
южноазиатская: южноазиатская
понять: понять
автор: авторов
оставлять: оставляли
доледникового: доледникового
течение: течение
производитель: производителей
преображение: преображение
выстроить: выстроили
наличие: наличием
митохондриальной: митохондриальной
изменчивость: изменчивость
цифра: цифр
пространство: пространствах
баскин: баскин
поведение: поведение
статья: статьи статья статью
населять: населяли
наймарк: наймарк
брэдли: брэдли
поток: потоков
послеледникового: послеледникового
берет: берет
получиться: получилась
основатель: основателей
древние: древних древние
интересный: интересная интересный
успех: успеха
байкал: байкал байкала
отмечены: отмечены
тип: тип
нужный: нужны
стать: стали
остров: островов
начать: начали начало
зебу: зебу
процесс: процесса процесс процессом
случайный: случайно
проведенное: проведенное
гёбекли: гёбекли
показательный: показательно
указывать: указывает
частый: частого
несет: несет
тысяча: тысячи
юг: юге
прародительница: прародительницами
тепе: тепе
геном: геномы геномах геномов геномам
тринити: тринити
местонахождение: местонахождения местонахождении
наука: науке
жилище: жилищах
наращивание: наращивание
меря: мере
озеро: озера
послеледниковых: послеледниковых
допуская: допуская
площадь: площади
