ассоциироваться: ассоциируются
оценивать: оценивают оценивали
работа: работы работой работа работ
соотноситься: соотносится
гопко: гопко
точка: точки
преступление: преступления
принимать: принимать
утвердить: утвердить
ученых: ученых
похожий: похожи
называть: называют
нашем: нашем
отвечающий: отвечающих
доктрина: доктрину
склонный: склонны склонных
обыденный: обыденной
особый: особые
рис: рис
важный: важны важно
повлиять: повлияла
отмечены: отмечены
находиться: находится
батлер: батлер
прошлое: прошлое
верующий: верующего верующих
анамнез: анамнезом
заложить: заложить
способный: способны
разработать: разработать
бог: боге богов
крупнейший: крупнейших
идет: идет
коррелируют: коррелируют
показать: показали
оценить: оценить
одно: одно
использовались: использовались
мыслить: мыслил
приключение: приключения
масса: массу
причем: причем
который: которым
предложить: предложить
определить: определить
марии: марии
экономический: экономические
отрицательный: отрицательная отрицательно
суриковый: сурикова
пуская: пуская
истинный: истинное истинному истинных
ломать: ломает
военком: военкома
неудивительный: неудивительно
травма: травмы травма травмами
четырех: четырех
дойл: дойл
повреждение: повреждений повреждения повреждение повреждениях повреждениями
полученные: полученные
приводящих: приводящих
образование: образованию
склонность: склонностью
значительный: значительное
фундаменталистских: фундаменталистских
социология: социологии
проблема: проблема
микаха: микаха
хромающего: хромающего
развитие: развитием развития развитие развитию
упомянуть: упомянули
обнаружить: обнаружили
пострадавший: пострадавшего
путешественник: путешественники
пациент: пациентов пациенты пациента
сша: сша
безоговорочный: безоговорочной
конфабуляцию: конфабуляцию
героический: героические
сторона: сторон стороны сторону
рознь: розни
экономист: экономистов
давать: давайте
использовать: использовать
делать: делать
древний: древнее
форма: формы форму форм
конан: конан
едва: едва
поврежденным: поврежденным
коррелировавших: коррелировавших
пуританского: пуританского
человеческий: человеческих человеческом человеческое
успеть: успел
превращаться: превращаются
мечтанья: мечтанья
лечение: лечения
психический: психическим психическими
интерес: интереса
ричарда: ричарда
встретить: встретили
удалось: удалось
отношение: отношения отношение
информация: информации
зачастую: зачастую
опытный: опытный
неприятный: неприятных
избравшие: избравшие
фундаменталистскими: фундаменталистскими
явление: явления явление явлений
аналогия: аналогии
фундаменталиста: фундаменталиста
кларка: кларка
понимать: понимают понимаю
мозг: мозга мозгом мозге мозгу
иметься: имелись
полушарие: полушария полушарие
купирования: купирования
большой: большой
томографии: томографии
резонансной: резонансной
смущать: смущает
ревностный: ревностным
доверие: доверием
повреждённый: повреждены
уходящими: уходящими
фрагмент: фрагмент
случай: случае
дорога: дороге
компьютерный: компьютерной
патологический: патологических
степень: степени
утомлен: утомлен
нарушая: нарушая
конфессия: конфессии
тепловой: тепловой
нарушение: нарушениями
осторожный: осторожным
протопоп: протопопом
опухоль: опухолей
функция: функции
безошибочный: безошибочную
независимый: независимо
поражение: поражение
послужить: послужило
касающихся: касающихся
навязчивый: навязчивых
задействовать: задействовать
поэтому: поэтому
вера: веру вере вера
существовать: существует существуют
вялотекущих: вялотекущих
рвение: рвения
говориться: говорилось
наивный: наивный
многие: многом
расположенный: расположены
погребение: погребение
вопрос: вопросам вопросе
ученые: ученые
найти: нашли
собственный: собственным
обладать: обладать
конфабуляции: конфабуляции
нужный: нужны
атеист: атеистов
гибель: гибель
отличать: отличают
полученной: полученной
часть: часть
медицина: медицине
преступный: преступное преступному преступным
войти: вошли
называться: называется
сице: сице
указывать: указывает указывают
верный: верным
соблазнительный: соблазнительна
интересовать: интересует
разный: разных разной разным разные разными
взгляд: взглядами взгляды взглядов
бредовый: бредовых
данные: данные данными данных
торможение: торможением
пример: примере примеры
исторический: исторические
добрый: добрым
совершеют: совершеют
фундаментализмом: фундаментализмом
нервный: нервных нервные нервная нервной
множество: множество
примешивается: примешивается
принять: приняли
молодой: молодой
затронуты: затронуты
ужас: ужасов
сформироваться: сформироваться
стык: стыке
специальность: специальностей
вид: виде
задача: задач
выдвигать: выдвигать
ним: ним
версия: версия
такой: таких таким
образ: образом
совпадение: совпадение
располагаться: располагались
веровать: верую
достаточный: достаточно
зрение: зрения
панталоны: панталонах
метода: методы
патология: патологий патологиями
иметь: имеет
нормальный: нормально
нетерпимость: нетерпимости
биолог: биолога
исследование: исследовании исследование исследования
определены: определены
неврологический: неврологическим неврологическими
меч: меч
нейробиологов: нейробиологов
участок: участки участков участка участками участках
область: областями областей области
совокупность: совокупность
факторы: факторы
выявить: выявить
дело: дело
влият: влият
военный: военного военную
функционировать: функционировать
кении: кении
подразумевать: подразумевает
увиденных: увиденных
поведенческий: поведенческим поведенческими
обезболивающий: обезболивающим
индекс: индексом
европеоид: европеоидами
исповедовать: исповедую
продвинутый: продвинутые
совпадать: совпадали
звучать: звучит
ковер: ковер
раб: рабом
перестать: перестанет
широкий: широко
идти: идти
заметный: заметно
формального: формального
косность: косностью
определять: определяют
мученик: мучеников
изображение: изображение изображения
стесняться: стесняются
фундаментализма: фундаментализма
группа: группа группы групп группах
обсуждаемой: обсуждаемой
прямой: прямо
химия: химии
открытый: открытая
припрятан: припрятан
создавать: создавать
уносить: уносил уносит
объективный: объективно объективному
чудо: чудесах
понимание: понимания
следовать: следовать следуют
получившие: получившие
противопоставлена: противопоставлена
коррелирующие: коррелирующие
обнаружено: обнаружено
ассоциация: ассоциаций
человечество: человечестве человечества
помощь: помощью
божество: божеством
соответствовать: соответствуют
тепловая: тепловая
общественный: общественных
судить: судить
связано: связано
карьера: карьеру
герой: героев
страдать: страдать
книга: книге книги
анализ: анализа
говоря: говоря
фрейд: фрейд
зная: зная
минеи: минеи
следующий: следующих
практик: практиками
аввакумом: аввакумом
сила: силой силу сила
вероятный: вероятно
отбор: отбор
привлечь: привлечь
иначе: иначе
американский: американских американского
отметить: отметить отмечу
неандертальцев: неандертальцев
сложный: сложное сложных
впоследствии: впоследствии
доверять: доверяю
содержать: содержит
вряд: вряд
узкий: узко
исключительный: исключительно
рисунок: рисунок
старый: старым
граничащего: граничащего
огонь: огонь
единственный: единственный единственно
жертва: жертв жертвы
тепловые: тепловые
уровень: уровнем
аномалия: аномалий
мышление: мышления мышление
влияние: влияние
понять: понять
бороться: бороться
выясниться: выяснилось
бегать: бегать
просвещение: просвещению
автор: автора авторами авторы
посвященной: посвященной
связь: связь
первый: первую первых
обычный: обычных обычного
описывать: описывает
будучи: будучи
мозговыми: мозговыми
положение: положение положений положении
галерея: галерея
ответственный: ответственными ответственных
история: истории
коррелируя: коррелируя
дезинформации: дезинформации
используются: используются
течение: течениям
вступать: вступают
третьяковская: третьяковская
кларк: кларк
ложный: ложных ложные ложными ложное
инфекционные: инфекционные
поврежденного: поврежденного
требоваться: требуется
процесс: процесс процессы
имеющий: имеющие
участник: участники
бред: бредом бред
воспоминание: воспоминаний воспоминания воспоминание
поскольку: поскольку
заботиться: заботится
расстройство: расстройствам
условный: условны
болезнь: болезни
новейший: новейшего
характерный: характерную
сравнить: сравнили
посланец: посланцами
род: рода
удаление: удаление
шкала: шкале шкалой
религиозность: религиозностью религиозности
актуальный: актуально
центр: центре центры
препятствующие: препятствующие
отец: отец
структура: структуры
второй: вторую вторых
сожаление: сожалению
инстанция: инстанции
показано: показано
специальный: специально
вперед: вперед
идея: идей
слабый: слабее
ассоциированных: ассоциированных
неандертальцы: неандертальцы
брезговать: брезгуют
межконфессиональной: межконфессиональной
функционально: функционально
зло: злу
упомянутым: упомянутым
хромота: хромоту
пылкий: пылкого
связанный: связанные связанной связанных
меньший: меньшей
божественный: божественном
таки: таки
непременный: непременно
любопытный: любопытно
поведение: поведение поведению поведением
физиологические: физиологические
статистически: статистически
исходя: исходя
контролирующие: контролирующие
тщательный: тщательно
склонять: склоняет
подчеркивают: подчеркивают
оттенок: оттенки
вывод: выводы
выдумка: выдумкам
картина: картина
сайт: сайта сайте
благой: благо
инсульт: инсульты
нейрон: нейронов
тяжелых: тяжелых
мнение: мнению
низкий: низкими
обратный: обратное
пересекаться: пересекаются пересекается
определенных: определенных
понятие: понятие
частить: части
коррелирует: коррелирует
изначальный: изначально
дева: девы
превращающую: превращающую
статья: статьи
присутствие: присутствие
тематика: тематику
недочетов: недочетов
преодолевать: преодолевать
тесный: тесно
итак: итак
природа: природы
либо: либо
дополнительный: дополнительным дополнительные
дойти: дошло
кулиса: кулисами
михаил: михаил
набор: набор набора
непогрешимый: непогрешимую
мелкий: мелких
затронутые: затронутые
вероучение: вероучения
стимул: стимулы
зигмунд: зигмунд
предположить: предположить
ясный: ясно
оказаться: оказаться оказались
опросников: опросников
относительный: относительно
белый: белый
формирование: формирование
высокий: выше высокими высоким высокие
активный: активно
показаны: показаны
получены: получены
взять: взять
учение: учение учению
боль: боли боль болью
непосредственный: непосредственно
социальный: социальных социальное социально
предвзятость: предвзятостью
здоровый: здоровых
карта: карта карты карту картой
предположительно: предположительно
религиозный: религиозный религиозным религиозные религиозного религиозных религиозному религиозной религиозное религиозном религиозную
говорить: говорю
выборка: выборок выборки выборках
гражданский: гражданских
терапия: терапию
основа: основу основе
унесший: унесший
выполнение: выполнения
контур: контур
стоять: стоит стоять
разуметься: разумеется
территория: территории
пер: пер
некритичностью: некритичностью
исследователь: исследователей исследователи
ветеран: ветераны
специфический: специфические специфическая
ранний: ранней
стать: стать
жить: живу
левый: левое
гипотеза: гипотезы
адепт: адептом
подобный: подобного
человек: людей человека людям
трудный: трудно
интересный: интересно
правый: правого правое
столетие: столетиями
важность: важность
феномен: феномен
миллион: миллионам
уступать: уступают
ранение: ранения
теплыми: теплыми
фундаментализм: фундаментализм
конфликт: конфликтов конфликта
система: системе
слово: словами
оговаривать: оговаривают
фантастически: фантастически
война: войнам войн войны
фанатизм: фанатизма
чей: чьи
поврежденными: поврежденными
добавить: добавлю
резня: резня
положительный: положительно положительная
пространственный: пространственно
внушенным: внушенным
спутник: спутник
проявляясь: проявляясь
бытовой: бытовых
снимок: снимки
изменить: изменило
шанс: шансы
следствие: следствием
гудибрас: гудибрас
показывать: показывают
кора: коре
одну: одну
эффект: эффектом
насколько: насколько
балл: баллами баллы
обожествив: обожествив
немалый: немало
четьи: четьи
сознание: сознания
голова: голову головы
норма: норм
справа: справа
мировоззрение: мировоззрение
явный: явном
поиск: поисках
постинсультной: постинсультной
радикал: радикалы
знание: знание знанию
соответствие: соответствии
корень: корнями
слева: слева
увеличивать: увеличивает
интерпретация: интерпретации
являться: является
цвет: цветами
различный: различной различным различными
вишняцкого: вишняцкого
подавляющий: подавляющие
третий: третьих
душить: души
социолог: социологов
последний: последнее последние последней
применяя: применяя
гипертрофированных: гипертрофированных
новый: новое
весьма: весьма
уайт: уайт
преследовании: преследовании
выполнять: выполняют
тепловую: тепловую
привести: привели привести
какой: какие каких какого
составлена: составлена
косвенно: косвенно
выявлены: выявлены
сей: сим
используя: используя
связаны: связаны
мочь: могли
некритичное: некритичное
христианин: христианами
морозова: морозова
истина: истине истину истиной истина
выраженными: выраженными
фундаментализме: фундаментализме
отрицать: отрицает
примерно: примерно
постулат: постулатах постулатам
пространство: пространстве
морозовой: морозовой
приходиться: приходится
оказывать: оказывает оказывать
проводить: проводить
африка: африки
боярыня: боярыней боярыня
пастор: пастора
любой: любые любая
объединённый: объединены
рождаться: рождаются
чистый: чисто
святой: святой
протестант: протестанта
подсчеты: подсчеты
возможность: возможность
религия: религия религии
самый: самых самые
изучать: изучала изучали
магнотно: магнотно
духовный: духовным
радикализм: радикализма
таковой: таковым таковой
физиолог: физиологов
доказательство: доказательством
естественный: естественный
оценивающим: оценивающим
вовсе: вовсе
число: числе число
фундаментализму: фундаментализму
головной: головного
считать: считать считают считал
получена: получена
современный: современных
москва: москва
основополагающий: основополагающую основополагающими основополагающему
поврежденные: поврежденные
теплые: теплые
элемент: элементы
феодосия: феодосией
заметем: заметем
обеих: обеих
эволюционный: эволюционной
намекать: намекает
поработать: поработать
настолько: настолько
затронуть: затронули
раса: расы
дорогой: дорогой
верование: верований верования
сам: самое
критический: критическое
опасный: опасные
частность: частности
социум: социум
гораздо: гораздо
предполагать: предполагает
десяток: десятков
строгий: строго
позволять: позволяет
субъективность: субъективности
обсуждаемая: обсуждаемая
биология: биологии
вьетнамский: вьетнамской
сходный: сходные
причина: причин
речь: речь
избежание: избежание
сверхъестественный: сверхъестественном
помешательство: помешательством
сеть: сетей сети сеть сетях сетью
психолог: психологов психологам психологи
сопоставить: сопоставить
опросники: опросники
логичный: логично
возможный: возможно
замена: замены
годы: годы
влиять: влиять
этический: этических
незыблемый: незыблемую
мысль: мыслей мысль
источник: источник
объяснять: объясняет
недружелюбностью: недружелюбностью
воззрение: воззрениями воззрения воззрений воззрениях
универсальный: универсальные
вещь: вещь
сильный: сильнее сильно сильна сильное
например: например
судьба: судеб
функциональной: функциональной
столько: столько
больший: большей большая большего
содержащий: содержащее
всякий: всякого
конфабуляцией: конфабуляцией
встреча: встречах
сэмюэль: сэмюэль
хвататься: хвататься
оружие: оружие
разумный: разумно
думать: думаю думать
докинза: докинза
мэтью: мэтью
крупный: крупных
проверять: проверяли
решившие: решившие
чувство: чувство
кит: китах
необходимый: необходимо
последовательный: последовательного
другой: другим другими другого
представление: представлений представления
помимо: помимо
безо: безо
протестантский: протестантскому
отмечать: отмечают
распространить: распространить
отдельный: отдельно
полагать: полагаю
государственный: государственная
вслед: вслед
установить: установили
поврежденных: поврежденных
опубликованными: опубликованными
сформировалась: сформировалась
радикальный: радикальную
известный: известно известна
последствие: последствий последствия
направление: направлений
включены: включены
некоторые: некоторые некоторым
биологический: биологические биологических
результат: результате результаты результат
каждый: каждого каждой
маловероятно: маловероятно
лишённый: лишена
метод: методов
шагнуть: шагнуло
одни: одни
грубый: грубой
ход: ход ходе
жизнь: жизней жизни
историк: историк
чужак: чужакам
умирать: умираю
