выяснить: выяснить
след: следы
бразильский: бразильских бразильской
синхротронного: синхротронного
самый: самых самый
коллектив: коллектив
резец: резцы
превосходить: превосходил
странный: странный
эндокрана: эндокрана
избегать: избегать
вымирание: вымиранием
среди: среди
ограничивать: ограничивают
прийти: прийти пришли
выбор: выбора
клык: клыки клыка клыков клык клыками
верхний: верхних верхнего верхней верхнем верхнюю верхний верхнее верхние
триасовом: триасовом
адаптированные: адаптированные
экзаэретодоны: экзаэретодоны
ребёнок: детей
коронка: коронку
канал: канал
край: края
например: например
терять: теряют
динамозух: динамозух
построить: построить
отверстие: отверстие отверстия
сомкнутый: сомкнутом
мышь: мыши
уступать: уступал
энцефализации: энцефализации
сородич: сородичей
первый: первыми первые первых
особенность: особенностей особенностях особенности особенность
отметив: отметив
экзаэретодонов: экзаэретодонов
конкуренция: конкуренции
разделив: разделив
продольный: продольном
нацеливаться: нацеливался
луковица: луковицы
достигнуть: достиг
подробнее: подробнее
уничтожена: уничтожена
расцвет: расцвета
представитель: представители
животный: животной
триас: триас
фауна: фауны
меря: мере
заклыковые: заклыковые
шея: шею
конкурируя: конкурируя
возникнуть: возникли
неудивительный: неудивительно
диаметр: диаметром
платеозавра: платеозавра
костный: костная
описанный: описанный описан
мозговой: мозговой
ранее: ранее
галезавра: галезавра
близкий: близких
переживать: переживали
шакал: шакала
смена: смену смена
нижний: нижние нижний нижнюю нижних нижней
поскольку: поскольку
реконструкция: реконструкция
видный: видно
проведенное: проведенное
средний: среднем средним
каталожный: каталожный
вывод: выводу
физический: физической
пробивать: пробивали
наших: наших
отдельный: отдельные
обсуждаемой: обсуждаемой
начало: начале
вырастать: вырастали
сканирование: сканирование
биомеханика: биомеханики
переживавшей: переживавшей
форма: форм форме
черта: черт
жаркий: жарким
средство: средства
помощь: помощью
растительноядных: растительноядных
частить: части
солидный: солидные
лесной: лесной
труцидоцинодона: труцидоцинодона
передний: передние передний
смочь: смогли
локоть: локти
номер: номер
труцидоцинодону: труцидоцинодону
должный: должен
томографии: томографии
структура: структура
готовый: готовых
найдены: найдены
экономный: экономно
достигавшие: достигавшие
мария: мария
аргентина: аргентины
проводиться: проводилось проводилась
охота: охоте охоты
учетом: учетом
кстати: кстати
позднемеловой: позднемеловой
синхротронную: синхротронную
зуб: зубы зуба зубов
эффективный: эффективно
псевдозухии: псевдозухии
микрокомпьютерную: микрокомпьютерную
старый: старого
велеть: вели
справа: справа
голотип: голотип
нечто: нечто
обнаружено: обнаружено
прекращаться: прекращалась
цинодонты: цинодонты
земля: землю земли земле
дело: делом
томографию: томографию
вид: вид виды вида
труцидоцинодон: труцидоцинодон
элемент: элементы элементами
смят: смят
остальное: остального
раскрытие: раскрытия
расчета: расчета
среда: среде
передвижение: передвижению
великан: великаны
подземный: подземных
излучение: излучения
надугловая: надугловая
вывихнуть: вывихнуть
основание: основания основании
дожили: дожили
баловать: баловали
сквозь: сквозь
обозначение: обозначения
служить: служили
подсчитать: подсчитать
обитание: обитания
придавать: придавало
породившей: породившей
причудливый: причудливых причудливые
потребовать: потребовали
располагаться: располагался
межполушарная: межполушарная
протерохампсами: протерохампсами
палеозоя: палеозоя
лапа: лапы
анатомия: анатомии
травоядный: травоядных травоядные
триасовые: триасовые
родственник: родственника родственниками
исследование: исследование исследовании
растительноядные: растительноядные
передвигаться: передвигался
возрастающий: возрастающую
слева: слева
длина: длину длиной длина длине
костя: костей
раннетриасового: раннетриасового
согласный: согласно
основный: основном
бразилия: бразилии
подробность: подробностях подробности
новый: новых новое
необычный: необычных необычную необычным необычный
больший: большая
пермо: пермо
основа: основе
некрупный: некрупной
время: временем времена
рисунок: рисунок рисунке
кошка: кошка кошкой кошки
голотипа: голотипа
входить: входил
живших: живших
вода: воды
нерассосавшийся: нерассосавшийся
оцененном: оцененном
преддверие: преддверия
последующий: последующих
охотившиеся: охотившиеся
тело: тела телом тело
пекарь: пекари
несмотря: несмотря
роль: роль роли
вроде: вроде
цинодонт: цинодонт
центр: центре
стоять: стоит
сравнение: сравнения
правило: правиле
подстилка: подстилке
остаток: остаток остатков
ниша: ниши нишу
жила: жил
ноздря: ноздрей
гипофиз: гипофиз
размер: размеры размер размерам размеров размера
динозавр: динозаврами динозавры
лес: лесу
этозавром: этозавром
угол: угол
сверхдлинные: сверхдлинные
формация: формации
сантиметр: сантиметров сантиметра
необходимый: необходимая
пример: примеру
зубной: зубного
вечный: вечно
окно: окно
выражены: выражены
внимание: внимание
рептилия: рептилий рептилиям рептилиями рептилии
триасовый: триасовый
доминирующий: доминирующей доминирующих
последний: последних последнюю последняя
приходиться: приходилось
полонозуха: полонозуха
сторона: стороны
угловой: угловая
иметься: имеются
охотиться: охотиться
гигантский: гигантскими гигантские
мел: мелу
точный: точно точную
подсчета: подсчета
защищать: защищали
пар: пару
гипертрофированные: гипертрофированные
ухо: ухом
предоставлять: предоставляли
полный: полному полной
ставрикозавров: ставрикозавров
описать: описали
строение: строение
прямой: прямые прямой
любой: любого
движение: движения
достижение: достижении
интеллект: интеллекте интеллект
поднимать: поднимает
наблюдаться: наблюдалось
ринхозавры: ринхозавры
замена: замены
пытаться: пытается
новиковская: новиковская
небольшой: небольшой небольшая
исследователь: исследователям исследователи исследователей
мозг: мозг мозга мозгом
заполонившие: заполонившие
листрозавров: листрозавров
разнообразнее: разнообразнее
продолжавшейся: продолжавшейся
рисковать: рисковал
тесцелозавр: тесцелозавр
сосредоточиться: сосредоточились
закрывании: закрывании
отдавать: отдавал
оцененной: оцененной
позднетриасовым: позднетриасовым
цинодонтов: цинодонтов
обрабатывать: обрабатывать
метр: метров метра
миллиметровый: миллиметров
попытка: попытке
построенной: построенной
неизвестный: неизвестны
цвет: цветом
гладкий: гладкие
любопытный: любопытно любопытная
размещаться: размещались
эпоха: эпоху
выявить: выявить
составлять: составляла составляет
наоборот: наоборот
набор: набор
южноамериканский: южноамериканский
крыса: крысы
модель: модель модели моделей
схватить: схватить
полушарие: полушария
выпрямленные: выпрямленные
синапсиды: синапсиды
который: которую
спереди: спереди
изображение: изображениях изображении
такой: таких
внушительный: внушительные внушительных
стадо: стадо
потягаться: потягаться
подробный: подробно
львиный: львиных
боковой: боковой
терморегуляции: терморегуляции
диверсификация: диверсификацию
корм: корм
опираясь: опираясь
юар: юар
торчать: торчат
интерпретировать: интерпретировали
разный: разным
большой: большое
скелет: скелету скелета
преимущество: преимущество
намного: намного
ученые: ученые
использовать: использовал
массивность: массивность
благодаря: благодаря
предположить: предположить
парафлоккулус: парафлоккулус
резкий: резко
обратить: обратите
скудный: скудную
крайний: крайней крайне
мягкий: мягкую
занимать: занимали
вдалеке: вдалеке
яркий: ярких
видимый: видимому
орбитосфеноид: орбитосфеноид
краткий: краткие
картинка: картинку
переслать: перешли
переход: переход
реконструировать: реконструировать
состояние: состоянии
желтым: желтым
полукружный: полукружный
борозда: борозда
развить: развил
обзавелся: обзавелся
грубый: грубый грубые
увидеть: увидеть
бродить: бродили
подсчетов: подсчетов
предпочтение: предпочтение
детеныши: детеныши
морда: морде морды
явный: явное
кость: костям кость
помогавшее: помогавшее
указывать: указывает
юре: юре
сыграть: сыграл
появиться: появились
отмечены: отмечены
одна: одна
вблизи: вблизи
никакой: никаких
конкурировать: конкурировать
челюсть: челюсть челюсти челюстей
разнообразия: разнообразия
хищник: хищников хищники хищник
источник: источник
включая: включая
далеких: далеких
мочь: могли
будущий: будущими
архозаврами: архозаврами
позднетриасовых: позднетриасовых
предыдущий: предыдущего
группа: группой группы групп
синхротронной: синхротронной
череп: череп черепа черепом черепу черепе
образ: образ
четырем: четырем
паратипам: паратипам
длинный: длиннее
желтый: желтый
голотипом: голотипом
развернуты: развернуты
оказаться: оказались оказался оказалось окажется
птицетазовый: птицетазовый
сша: сша
отделить: отделить
зажимать: зажимают
эволюционный: эволюционных
великобритания: великобритании
триасового: триасового
циногнат: циногнат
снизу: снизу
шишковидное: шишковидное
день: дня
хозяин: хозяевами
португалия: португалии
подход: подходов
зависимость: зависимости
либо: либо
башковитый: башковитый
реконструированный: реконструированный
счет: счет
анна: анна
интерпретация: интерпретации
обнаружить: обнаружили
пообедать: пообедать
планета: планете
наличие: наличию
млекопитающий: млекопитающих млекопитающим млекопитающие
позднетриасового: позднетриасового
экосистема: экосистемах экосистема
крокодилов: крокодилов
триасовым: триасовым
целый: целом
продвинутый: продвинутые продвинутое
кончик: кончики
оценка: оценка оценкам
полость: полости полость
саблезубый: саблезубой
текущий: текущему
объеме: объеме
выпавшего: выпавшего
исключено: исключено
верх: верха
цинодонтом: цинодонтом
регулярный: регулярная
тот: той
быстрый: быстрому быстро
цинодонта: цинодонта
плотоядный: плотоядных
доставать: доставали
вывих: вывиха
внутренний: внутреннюю внутренним
статья: статьи
немалый: немало
триасе: триасе
поваленном: поваленном
интенсивный: интенсивную
сайт: сайта
предположительно: предположительно
большинство: большинство
современный: современных современным современные
конечность: конечности
одно: одно
найдено: найдено
походить: походило
слепок: слепок
тапир: тапиров
высокий: выше
отношение: отношению
изображено: изображено
нора: норах
представленный: представленным
масса: массе
зазубрина: зазубринами зазубрины
таки: таки
питаться: питались
роющий: роющий
сверху: сверху
сбоку: сбоку
непростой: непростым
житель: жителей
обыкновенный: обыкновенного
всеядный: всеядных всеядные
гибкость: гибкости
межлуковичная: межлуковичная
пресмыкающееся: пресмыкающиеся
наследник: наследник
ряд: ряд ряда
триасовых: триасовых
дать: дало
жизнь: жизни
долгий: дольше
насквозь: насквозь
заметный: заметно
редкий: редким реже
общий: общей общая
циногната: циногната
миллиметр: миллиметра
изучить: изучить изучили
посткраниального: посткраниального
понять: понять
сустав: сустава
крупный: крупный крупные крупных крупном крупнее крупное крупного крупными крупным
предшественник: предшественников
используемый: используемых
цинодонту: цинодонту
уступая: уступая
расходовать: расходуют
появившиеся: появившиеся
челюстного: челюстного
трехмерной: трехмерной
возможный: возможно
предок: предки
физиология: физиологии
суровый: суровых
вытеснив: вытеснив
проходить: проходили проходила
уникальный: уникальные
отмечено: отмечено
место: места
марии: марии
домовый: домовой
удивительный: удивительная
часть: часть
синапсидами: синапсидами
занять: занять
состав: состав
нынешний: нынешней
североамериканский: североамериканский
различный: различных
отмечать: отмечали
выступать: выступали
предполагать: предполагать
риограндии: риограндии
делать: делают
автор: авторов авторами авторы
наземный: наземной
левый: левых левого
жевание: жевании
архозавров: архозавров
миниатюризации: миниатюризации
роющимися: роющимися
период: периоде период периоды периода
синапсид: синапсид
растительный: растительной растительный
герой: герой
оставаться: оставались
сравнительный: сравнительно
коэффициент: коэффициента коэффициент
мумия: мумии
разнообразный: разнообразный
итог: итоге
сиамский: сиамской
успешный: успешной
условие: условиях
вел: вел
отметить: отметить
суперзубы: суперзубы
качество: качестве
обычный: обычной
значительный: значительную значительно
лисовиция: лисовиция
мезозойский: мезозойских
составить: составил
зверёк: зверьками
играть: играть играли
пища: пищей
встречаться: встречаются
свобода: свободу
хватать: хватало
остается: остается
ранний: раннем ранними ранних
размерный: размерном
европейский: европейском
хищный: хищные хищных хищными
дерево: дереве
рассмотреть: рассмотреть
направление: направлении
доисторический: доисторического
поздний: позднем поздние поздних позднего
корень: корня
тираннозавра: тираннозавра
примитивный: примитивные
исключение: исключения
условный: условные
заглавный: заглавном
вероятный: вероятно
франция: франции
эндокран: эндокран
острый: острые
дицинодонты: дицинодонты
сохранность: сохранность
листрозавры: листрозавры
псевдозухиями: псевдозухиями
избежать: избежать
палец: пальцев
капибара: капибара
зрелость: зрелости
затылочный: затылочное
возможность: возможность возможности
засушливый: засушливым засушливому
тонкий: тонкую
зубастый: зубастые
калорийный: калорийной
мелкий: мелкими
норный: норный
обонятельный: обонятельные
наряд: наряду
существовать: существовали существовал
доходить: доходила
замещающих: замещающих
пищать: пищу
известный: известного известно известна
огромный: огромные
энергия: энергию
санта: санта
добыча: добычи добыче
позволить: позволила
сидящего: сидящего
использование: использованием
пробайногнатов: пробайногнатов
присутствовавшее: присутствовавшее
теплокровности: теплокровности
животное: животного животными животное животных
вопрос: вопрос
обеими: обеими
равный: равен равным
бразилодона: бразилодона
значение: значение
фрагмент: фрагмент фрагментам
триаса: триаса
микрокомпьютерной: микрокомпьютерной
ставшему: ставшему
демонстрация: демонстрации
принадлежащий: принадлежащих
соответственный: соответственно
сложнее: сложнее
насекомоядный: насекомоядными
различие: различия
относительный: относительный относительных
другой: другого
найденный: найденный
уменьшиться: уменьшились
предотвращение: предотвращения
наступить: наступила
вес: веса весу
мерка: меркам
рентгеновский: рентгеновской рентгеновскую
уцелеть: уцелели
продержаться: продержались
внешний: внешнего
своем: своем
продолжать: продолжали
конец: конца конце
ямка: ямка ямки ямками
обозначена: обозначена
поэтому: поэтому
класс: классе
особь: особь
бокового: бокового
частность: частности
