погрешность: погрешностью
хьюмасоном: хьюмасоном
демократия: демократия
верный: верна
исследуя: исследуя
установленный: установленными установленных
достаточный: достаточно
практически: практически
учета: учета
синтез: синтезу
масса: массе массой
расселла: расселла
прославленный: прославленной
безразмерный: безразмерная
пожаловать: пожалуй
юноша: юношей
приблизительный: приблизительно
выраженная: выраженная
хаббловская: хаббловская
ветер: ветра
одинаковы: одинаковы
герцшпрунга: герцшпрунга
усовершенствование: усовершенствования
отпечаток: отпечаток
дробь: дробь
инфракрасный: инфракрасных
коллабораций: коллабораций
интеллект: интеллекта
благодаря: благодаря
избавиться: избавиться
массив: массив
библиографических: библиографических
литий: лития
причина: причины
космический: космическом космических космическому космическую космической космическое космического
имя: имени
аналог: аналог
приобретать: приобретает
мпк: мпк
разный: разными разных
вошедших: вошедших
вспомнить: вспомнить
тип: типа
флуктуаций: флуктуаций
земля: земли земле
равный: равен равна равный равной равно
релевантна: релевантна
углеродный: углеродно
дмитрия: дмитрия
стандартный: стандартных
анизотропно: анизотропно
крайний: крайней
круг: круга
соединиться: соединились
какой: какую какие
масштабный: масштабный масштабного
бимодальным: бимодальным
попросить: попросил
самостоятельный: самостоятельными
показывать: показывает показывают показывали
близкий: близка близок близкое близких близкие
межгалактический: межгалактические
эволюция: эволюцию эволюции
потерять: потеряет
плотность: плотности
туманность: туманности туманностей
соотношение: соотношение соотношениями
оценка: оценки оценке оценку
нынешний: нынешнего нынешней
причем: причем
адама: адама
полученную: полученную
приемника: приемника
расчет: расчет
возможность: возможность
нагретыми: нагретыми
обнародованы: обнародованы
оказаться: оказались оказалось
молодой: молодой
физика: физике физики
любой: любом любых
сравнение: сравнению
применимый: применима
конкретно: конкретно
кончина: кончины
синить: синим
врезать: врезать
подкрепить: подкрепить
открыть: открыли
происхождение: происхождением
барионных: барионных
контекст: контексте
иссякнуть: иссякнут
расшириться: расширятся
основанный: основанных
астроном: астроном астрономы астрономов астрономом
некоторые: некоторые
трехмерное: трехмерное
фактор: фактор
параллакс: параллаксов
млечный: млечного
момент: момент
частотный: частотных
интервал: интервале
гиперболический: гиперболической
очутиться: очутится
достижение: достижении
обсерватория: обсерватории
примерно: примерно
изотропию: изотропию
конечный: конечен конечном
мегапарсеках: мегапарсеках
развиваться: развиваться
каждый: каждым
бесчисленный: бесчисленные
секунда: секундах секунду
выгореть: выгорит
разброс: разброс
убедительный: убедительные
пришел: пришел
перевод: перевода
электромагнитный: электромагнитных
пойдем: пойдем
вычислять: вычислять
испещренным: испещренным
огромный: огромный
определяться: определяются
исходный: исходному исходной
одновременный: одновременно
совместный: совместной
выбросить: выбросит
показатель: показателей показателю
многократный: многократно
привести: привели привело
полный: полный
корректный: корректная
известный: известной известными известна известным известный известно
закон: закон закона
вершина: вершиной вершины
планка: планка
немалый: немало
решение: решению решения
история: истории история
кривизна: кривизны кривизна
продолжет: продолжет
работать: работал
отмечающими: отмечающими
дав: дав
осознано: осознано
доплера: доплера
сек: сек
слово: словах
астрофизики: астрофизики
свой: свой
сэндидж: сэндидж
публиковаться: публиковаться
оценивалась: оценивалась
стадия: стадии
увеличение: увеличением увеличение
миллион: миллион
лечь: легла
изотропное: изотропное
намного: намного
время: временем
слева: слева
запущенный: запущенной
представлять: представляет
измеренный: измерены
лежащих: лежащих
говорить: говорят
километр: километрах
константа: константы
фотопластинка: фотопластинка
низкий: низкую
беспокойство: беспокойство беспокойства
особый: особо
обратный: обратна обратных обратная
вполне: вполне
температура: температура температуру температуре температуры
светимостей: светимостей
оценить: оценить оценила
уступать: уступали
неизменный: неизменно
тот: той
объект: объектами объектов
прочитать: прочитать
исключить: исключить
короткий: короткое
смещение: смещения смещением смещение
квант: кванта кванты
труд: труд
цефеид: цефеид
говоря: говоря
фотонном: фотонном
предположение: предположений предположения
хаббловского: хаббловского
девяти: девяти
отметить: отметить
связанный: связанными связанных
ветвь: ветви ветвь ветвей
группа: группа
установлеными: установлеными
составлять: составляет
иметь: имеет имеем имеют
например: например
отчет: отчет
выходить: выходит
сопряжённый: сопряжена
расширяться: расширяться
сфера: сфере
проект: проекта
космологический: космологическим космологического космологических космологические космологической
конвенциональный: конвенциональное
вычислить: вычислить
резкий: резко
живем: живем
нуль: нуля нулю
цитированном: цитированном
вычисленных: вычисленных
несет: несет
кой: кое
выражение: выражением
менделеева: менделеева
евклида: евклида
гравитационный: гравитационно гравитационные
возраст: возрасту возрастов
частица: частиц
измерение: измерение измерения измерений измерениями измерениях
светимости: светимости
приемлемый: приемлем
довести: довести
обработка: обработки обработка
весьма: весьма
флуктуации: флуктуации
весь: всей
космологов: космологов
сей: сия
своем: своем
обрыв: обрыв
общий: общая общего
называться: называется
согласный: согласно
взаимный: взаимном
трехмерные: трехмерные
значение: значения значение значением значению значений значении
считаться: считались
разлет: разлет
абсолютный: абсолютную абсолютно абсолютной
метод: методов
извлечены: извлечены
подход: подходов
верхний: верхней
водород: водород водорода
первичный: первичной
плазма: плазмы
постоянный: постоянная постоянной постоянно постоянную
тема: тему
рождение: рождения
пространство: пространства пространство пространстве
пространственный: пространственная пространственной
рост: росту
фактора: фактора
мастер: мастер
средний: среднего
способ: способами способах способов способы
приводящее: приводящее
щель: щелью
годов: годов
космология: космологии
формулируется: формулируется
цефеидами: цефеидами
вновь: вновь
остыванию: остыванию
пар: пару
опубликованные: опубликованные
эдвин: эдвин
заняться: занялись
удаление: удаления удалении
математический: математической математически математический
родной: родное
начнет: начнет
упомянутой: упомянутой
мереть: мри
джеймса: джеймса
атмосфера: атмосферы
претерпеть: претерпит
газ: газа газе
величина: величине величину величина величины величин
первый: первая первому первым первое первых
метрика: метрика метрику
принятый: принято
статистический: статистические
калибровка: калибровка калибровки
сценарий: сценария
белая: белые
спектральный: спектральных
перейти: перейти
дойдет: дойдет
наблюдаться: наблюдается наблюдаются
темной: темной
былой: былых
стоять: стоит
частность: частности
демонстрация: демонстрации
перечеркнуть: перечеркнул
превращаясь: превращаясь
критический: критический
свободный: свободно свободные
гигагерц: гигагерц
подробней: подробней
таки: таки
поэтому: поэтому
искусственный: искусственного
анизотропии: анизотропии
теория: теория теории
гелий: гелию гелия гелий
евклидовой: евклидовой
раздел: раздела разделе
озаглавивших: озаглавивших
поскольку: поскольку
состоять: состоит
амплитуда: амплитуды
предшествующий: предшествующих предшествующего
мегапарсек: мегапарсек
произведение: произведение
шкала: шкале
уточнение: уточнением уточнение
относительный: относительному относительной относительно
корректировалась: корректировалась
найти: найти
нагретого: нагретого
произойти: произошло
великий: великое великих
полагать: полагаю
пиковый: пиковую
падать: падает
отправить: отправило
соответствовать: соответствует
мера: мера меру
сгорание: сгорания
промер: промерами
делаться: делается
придав: придав
упадет: упадет
принадлежать: принадлежит
галактика: галактику галактиками галактик галактики
отличный: отлична
распространяться: распространяются распространяться распространялись
изменение: изменению изменения
выражая: выражая
участие: участием
заключение: заключению заключение
французски: французски
технология: технологий
возникнуть: возникла возникли
оценивались: оценивались
свет: света
область: области область
дожигаться: дожигаться
угловой: угловым
популярный: популярное
называемый: называемый
заметить: заметил заметить
сжиматься: сжиматься
внешний: внешние
объяснимый: объяснима
малоизвестный: малоизвестном
удобный: удобно
солнечный: солнечную солнечный солнечного солнечной солнечное
появиться: появились появилось
устранить: устранить
многочисленный: многочисленными
эффективность: эффективность
лицо: лицах
вариант: вариантах
различие: различия
классический: классическую
чрезвычайный: чрезвычайно
гелиевый: гелиевая гелиевого
мироздание: мироздания
зонд: зонд зонда
тесный: тесно
член: члена
работа: работе работу работы
переходить: переходит
архив: архиве
вспышка: вспышка
дистанционный: дистанционных
фотонного: фотонного
стабильность: стабильность
обрываться: обрывается
уменьшаться: уменьшается
вычисленное: вычисленное
заключительный: заключительном
свеча: свечей
учет: учет
гидростатический: гидростатическую
набор: набор
точнее: точнее
биография: биографиях
астрофизика: астрофизика
сослаться: сошлюсь
штрих: штрихами
сайт: сайта
описание: описания
миллиард: миллиарда миллиардов
свыше: свыше
фото: фото
университет: университете
схема: схемы
отмечено: отмечено
постоянство: постоянство
ста: ста
разновидность: разновидность
планетарный: планетарной
пять: пяти
другой: другого
опыт: опыт
тридцать: тридцати
астрофизиков: астрофизиков
малый: малого малых
источник: источник источника источником источники
надлежащий: надлежащего
световых: световых
леметра: леметра
речь: речь
автор: авторов авторам
остывающий: остывающий
повторить: повторю повторила
элемент: элементов
прецизионный: прецизионных
горение: горение горения
слой: слои
литература: литературе
начало: начале началу началом
испускание: испускания
поправка: поправок поправки
интенсивность: интенсивность интенсивности
рамка: рамках
вывести: вывел
английский: английского
называть: называют
начнется: начнется
сказать: скажем скажешь
разница: разница
сергеевича: сергеевича
определять: определяет определяют
основание: основании
статья: статей статье статья статью
размерность: размерность размерности
иначе: иначе
качество: качестве
новый: новая новые новому новое
первооткрыватель: первооткрывателей
конец: конце
масштаб: масштабах масштаб масштабами масштабам
корректировка: корректировок
измерить: измерить
превысить: превысить
рисса: рисса
напомнить: напомню
фотометров: фотометров
порождены: порождены
заполнять: заполнял
десяток: десятков
наверняка: наверняка
открытие: открытия открытие
переменный: переменные переменную переменная
загореться: загорелся
хаббл: хаббл
звездные: звездные
свидетельство: свидетельство
земной: земного
радиотехнический: радиотехнические
полученных: полученных
милтон: милтон
сделаться: сделается сделался
скромный: скромный
снятый: снятая
сдвинуться: сдвинется сдвинулось
микрокельвинов: микрокельвинов
используемый: используемая
друг: друг друга
случиться: случилось
число: числе число числу
определяющим: определяющим
влиять: влияли
центр: центре
используя: используя
выявление: выявления
сто: сто
вид: виду вид
калифорнийском: калифорнийском
анализ: анализ
элементарный: элементарные элементарен
выложенный: выложен
вплоть: вплоть
осцилляции: осцилляции
вопрос: вопросов
имевшей: имевшей
место: мест место
темные: темные
удаленных: удаленных
карлик: карлик карлики
гидродинамика: гидродинамики
далеких: далеких
десятилетие: десятилетии
пропорциональность: пропорциональности
помнить: помнить
завышенным: завышенным
ясность: ясности
потеря: потере
окружающий: окружающее
удаться: удастся
состав: составе
определяющих: определяющих
магнитный: магнитной
фотометрических: фотометрических
солнце: солнца солнце
модель: модели
асимптотической: асимптотической
незамеченной: незамеченной
крупномасштабный: крупномасштабная крупномасштабные
некогда: некогда
итог: итоги
рисунок: рисунок
коэффициент: коэффициент коэффициента
литературный: литературной
придти: придти
решить: решил
идеальный: идеальная
накоплен: накоплен
подрастет: подрастет
дать: дали дала дать
регистрировать: регистрировать
годах: годах
понять: понял понять
гипотеза: гипотез гипотезы
судьба: судьбе
парсек: парсек
размер: размеры
цефеиды: цефеиды
атом: атомам
интересный: интересно
косвенно: косвенно
звезда: звезды звезду звезда
следовательно: следовательно
теоретический: теоретического
корреспондент: корреспондента
снимок: снимком
позволять: позволяет позволяют
помощь: помощью помощи
блестящий: блестящий
интерпретация: интерпретация
незначительный: незначительно
разрешение: разрешением
промежуток: промежутке промежуток
мода: моды
радиальный: радиальными радиальные радиальная
отрицательна: отрицательна
растяжение: растяжение
вещество: вещества
рожденных: рожденных
хаббловское: хаббловское
дело: дела дело
позволить: позволили позволила позволю
образ: образом
главное: главное
справедливый: справедлива
хороший: хорошей
произойдет: произойдет
материя: материи
системный: системные
рана: ран
серьезными: серьезными
близость: близости
взрыв: взрыва
имеющий: имеющего
лагранжа: лагранжа
определить: определить определил
вселенский: вселенская
необходимый: необходима необходимо
контраверза: контраверза
слабый: слабо
стремиться: стремится
пятьсот: пятьсот
черного: черного
бимодальность: бимодальность
удален: удален
написать: написал
подтвердить: подтвердили подтвердила
перманентный: перманентное
десятый: десятой десятых
светимостями: светимостями
замечательный: замечательное
период: периодами
питать: питают
собранный: собранная
космолог: космолог
единица: единице единицы единицу единица единиц
нашу: нашу
отделенных: отделенных
спектроскопия: спектроскопии
исторически: исторически
левин: левин
использовать: используют использовать
положение: положение
добавить: добавить
апрель: апреле
деталь: деталей
горбунова: горбунова
либо: либо
тело: тел тела
путь: пути путь
космос: космоса космосе космос
астрономические: астрономические
плоский: плоской
эпоха: эпоху эпохи
астрономия: астрономии
восходящий: восходящую
хотеть: хочу
оцениваются: оцениваются
хабблом: хабблом
гораздо: гораздо
заряд: заряда
новейший: новейших
название: название
годичных: годичных
цефеида: цефеида
декабрь: декабре
использующие: использующие
участник: участников
сферической: сферической
изложение: изложение
увеличивая: увеличивая
температурный: температурные
получившее: получившее
тогдашний: тогдашней тогдашнему
электрон: электрона электронами электроны
обзор: обзор обзоре обзора
диаграмма: диаграмме диаграммах
четырьмя: четырьмя
нашего: нашего
объяснение: объяснения
мой: мою моей
невозможный: невозможным невозможной
наса: наса
картирования: картирования
поверхность: поверхности
привел: привел
холодный: холоднее
барионные: барионные
алексей: алексей
отказываться: отказывались
параметр: параметром параметр параметра параметров
принцип: принципе
углерод: углерода
значительный: значительной
получено: получено
структура: структуры
современный: современной современное современному
займемся: займемся
большой: большой большого
жорж: жорж
загромоздить: загромоздило
подобный: подобно
воздержаться: воздержаться
многие: многие
показать: показал показали показать
корректироваться: корректироваться
чарльза: чарльза
световые: световые
осцилляций: осцилляций
американский: американский
такой: таких такими
увеличиваться: увеличивается
характеризовать: характеризует
астрометрическими: астрометрическими
кислород: кислорода
выявленными: выявленными
сделать: сделать сделало
факторов: факторов
препринт: препринт
полученные: полученные
цифровой: цифрового
скорректированы: скорректированы
глаз: глаза
зависимость: зависимость зависимости
определение: определения определение определению
разлета: разлета
полностью: полностью
отношение: отношению отношении отношение
наука: науки наук
прирост: прироста
пуща: пущей
дойти: дошло
вводится: вводится
совпадать: совпадают совпадает
уровень: уровня
запас: запасы
цвет: цвет цветом
пятнистый: пятнистым
тайный: тайна
изотропной: изотропной
робертсона: робертсона
наблюдающих: наблюдающих
измерительный: измерительных
давать: давали
февраль: февраля
дистанция: дистанции дистанциями дистанций
впечатанные: впечатанные
гигант: гигантов гигант
сторона: стороны
событие: событиях
прокомментировать: прокомментировать
расширение: расширения расширение
выдвинуто: выдвинуто
данные: данных данными данным данные
считать: считать
важный: важно
применяться: применяются применяться
консенсусному: консенсусному
скорый: скорее
умножить: умножить
американец: американец
формула: формулы формулу формулой формуле
двух: двумя
нашем: нашем
ряд: ряд ряда
международный: международная
интерес: интерес
беркли: беркли
разуметься: разумеется
излучение: излучений излучения излучение
пропорциональный: пропорционально
светового: светового
самый: самых самым
подписать: подписал
приведет: приведет
крупнозернистый: крупнозернистых
бельгийский: бельгийский бельгийском
получить: получил получим получить
цефеиду: цефеиду
положить: положили
служить: служит
двигаться: двигались
трех: трех
фотон: фотона фотонов
сверхновый: сверхновые сверхновых сверхновыми
следовать: следует
хьюмасон: хьюмасон
богатый: богаче
функция: функция
цефеидной: цефеидной
пойдет: пойдет
займет: займет
превратиться: превратится
заниматься: занималась
однозначный: однозначную
диапазон: диапазоне диапазону
карта: карта
российский: российских
выразить: выразить
записать: записать
выбрать: выбрать
пригодиться: пригодился
постепенный: постепенно постепенному
населять: населяют
регистрация: регистрации
выделенный: выделенных
группироваться: группироваться
участок: участками
надеяться: надеяться
последний: последних последнее последние
телескопический: телескопических
роман: роман
ускоренный: ускоренного
аппаратура: аппаратура аппаратуры аппаратурой
специалист: специалистов
предел: пределами
времен: времен
единственный: единственным
следующий: следующем следующие
поле: поля
информация: информация информации информацию
однородный: однородной однородное
соображение: соображения
получившим: получившим
выяснение: выяснение
нейтральный: нейтральным
бросаться: бросается
состояние: состоянии
смысл: смысле
метода: методы метод метода
перечисление: перечислением
вселенной: вселенной
расстояние: расстояний расстояния расстояние расстояниях расстояниями
сегодняшний: сегодняшней
галактический: галактических
андромеды: андромеды
запись: записи запись
нашим: нашим
одно: одно
называемая: называемая
применение: применение
колебание: колебания колебаниями
численный: численные численное численная численном
однородность: однородность
ссылка: ссылками ссылки
век: века веку
расхождение: расхождение
красный: красного красным красное красные красных красный
приближение: приближении
сам: самое
препринтов: препринтов
содержать: содержит
мелкозернистый: мелкозернистой
проблема: проблемы проблему проблем проблема
приведена: приведена
долгий: долгое
интерпретировать: интерпретировать
геометрия: геометрия геометрии
задается: задается
давление: давление
различный: различных
рожденного: рожденного
укладываться: укладывается
множество: множество
сотня: сотни
надежно: надежно
нашему: нашему
оранжевый: оранжевым
буква: буквой
спросить: спросить
двадцатикратное: двадцатикратное
направление: направлений направлению
испущенного: испущенного
точность: точностью
одна: одна
предположить: предположить
разгадать: разгадать
диккенса: диккенса
опустить: опустил
варьировать: варьируют
округленно: округленно
велик: велика
иметься: имеются
взрывообразное: взрывообразное
относиться: относится
коллаборация: коллаборация
трехмерного: трехмерного
линейный: линейная линейные
означать: означает
отличаться: отличается
уокера: уокера
облегчить: облегчить
чистый: чисто
сказанному: сказанному
прошлое: прошлом прошлого
опубликован: опубликован
описанный: описанные описана
барионной: барионной
небесный: небесной
прошлый: прошлую
репрезентативный: репрезентативный
термоядерный: термоядерное
обозначены: обозначены
июнь: июня
фидуциальным: фидуциальным
нулевой: нулевая
арифметика: арифметикой
сжатие: сжатие
порог: порог
дается: дается
звезд: звезд
дает: дает
возможный: возможно возможным
пыль: пыль
расположенный: расположена
независимый: независимыми
версия: версиях
задаваться: задаются
случай: случае
зона: зона
телескоп: телескопе телескопах телескопом телескопа
физо: физо
возникновение: возникновению
вряд: вряд
библиографической: библиографической
превышающую: превышающую
достигать: достигают
столетие: столетия столетии
существовать: существует существовать
называемого: называемого
подробность: подробностей
счете: счете
спектрограф: спектрографами
основный: основные основных
журнал: журнале
аномальный: аномальных
усложнить: усложнили
принципиальный: принципиально
узкий: узком
видимый: видимые видимой видим
решаемая: решаемая
сказано: сказано
претерпевать: претерпевает
увеличиться: увеличится
дальнейший: дальнейшем
посредство: посредством
ядро: ядре ядро ядра ядрами
называемой: называемой
называемых: называемых
опубликовать: опубликовало
простой: простой простое
начать: начало начал
явный: явно
слоановского: слоановского
нести: несут
отдалены: отдалены
хаббловской: хаббловской
читатель: читателям
агентство: агентство
доступный: доступна
выражать: выражать
выглядеть: выглядело
зрение: зрения
анизотропию: анизотропию
формально: формально
описывающие: описывающие
эрудиция: эрудиции
располагая: располагая
альберт: альберт
настолько: настолько
обнародовать: обнародовала
загромождать: загромождать
завершиться: завершился
сильный: сильно
опровергнуты: опровергнуты
годами: годами
средство: средством
май: мая
система: систему системе
электронный: электронном электронно электронный
быстрый: быстро
поступить: поступил
максимум: максимума
поверхностный: поверхностная
важнейший: важнейшим
отнюдь: отнюдь
кислородный: кислородный
ранний: ранней
эффект: эффекта
укрепление: укрепления
побольше: побольше
ошибочный: ошибочно
бимодальности: бимодальности
перечеркнутая: перечеркнутая
оптический: оптические оптических оптической
закончиться: закончатся
поляризация: поляризация поляризации
микроволновый: микроволнового
расшифровка: расшифровка
след: следы
лежать: лежат лежит
ассистент: ассистент
творец: творцах
измерять: измерять
технический: техническое техническими
изображение: изображение
удалось: удалось
результат: результаты результатов результатах результатам
спектр: спектров спектр спектром спектра
нашить: нашей
предложение: предложение
целый: целом
большинство: большинства большинству
светимость: светимость
достоверность: достоверностью
сообщение: сообщение
хаббла: хаббла
напечатана: напечатана
обе: обе
полученное: полученное
кабинет: кабинете
окончательный: окончательно
команда: команды
начнем: начнем
скопление: скопления скоплениями
физический: физическом физические
обозначать: обозначать
прежнего: прежнего
тонкий: тонкий
звуковой: звуковые
европейский: европейского
приходить: приходят
характеристика: характеристик
переименованный: переименованный
градус: градуса градусов
воспользоваться: воспользоваться
увеличивать: увеличивает
беспокоящие: беспокоящие
знак: знак
полоса: полосах
утверждаться: утверждается
чей: чья
предложить: предложу
отклонение: отклонения
ход: ходе
постаревшее: постаревшее
приведены: приведены
несколькими: несколькими
вывод: вывод
леметр: леметр
медленный: медленно
свестись: свелись
основа: основе основу
возрастать: возрастают
реальный: реальная реально реальные
умноженную: умноженную
прямой: прямо прямыми
представить: представило
процесс: процесс
упасть: упала
семи: семи
будущий: будущей будущее
волна: волн волны
планета: планеты
намеком: намеком
описать: описал
новизна: новизной
фигурально: фигурально
универсальный: универсальная
книга: книгу книге
выражаясь: выражаясь
положительна: положительна
частить: части
использование: использовании использование
семейство: семейства
фотонных: фотонных
который: котором которую которое
схожий: схожую схожие
уместный: уместно
обратиться: обратимся
реликтовый: реликтового реликтовое реликтовых
планк: планк
прочить: прочь
аллан: аллан
акустический: акустические акустических
опубликованной: опубликованной
феномен: феномен
происходить: происходит
вызывать: вызывало
усугублять: усугубляют
длина: длины длина
световой: световой
правда: правда
принимать: принимать
фон: фона
скорость: скорость скоростями скорости скоростях
вселенная: вселенная
массы: массы
фаза: фаза фазе
выводиться: выводятся
поначалу: поначалу
фридмана: фридмана
радиус: радиус
продолжительный: продолжительной
подчеркивается: подчеркивается
звук: звуков
детальный: детальный детальными
незадолго: незадолго
относительность: относительности
подробный: подробно
оболочка: оболочки
белый: белый
руководство: руководством
публикация: публикации
трудность: трудностями
стать: стали стала стало
видеть: видеть видит
эйнштейн: эйнштейн
мочь: можем
надежда: надежду надежды
единый: единой
краткий: кратко
форма: форма
помимо: помимо
половина: половины
охлаждаться: охлаждаются
высокий: выше высокой
деться: делась
остаться: осталась осталось
меря: мере
лето: летом
наблюдение: наблюдений наблюдения наблюдениям наблюдение наблюдении
январь: январе
возрастет: возрастет
кельвинов: кельвинов
аппарат: аппарата
поток: потоков
ведущая: ведущих
напряжение: напряжение напряжения
достигшего: достигшего
наложить: наложили
лёгкий: легко
первоначальный: первоначальным
получены: получены
сцеплены: сцеплены
задача: задачу задача задачи
пометить: пометил
справа: справа
точка: точки точке
порядок: порядку порядка
аудитория: аудитории
надежной: надежной
ужать: ужать
уэбба: уэбба
точный: точные точного точное
превышать: превышает превышают
рекомбинации: рекомбинации
факт: факт
ранее: ранее
хабблу: хабблу
сохранять: сохраняет
производная: производной
говориться: говорилось
опираться: опираются опиралось
вырасти: вырастет
светить: светило
координаты: координатах
остается: остается
