ранний: ранних
получить: получить
олдувайских: олдувайских
западный: западной
вес: весу
короткий: короче
плечевую: плечевую
считать: считать
связь: связи
деятельность: деятельности
стать: стали
крокодилов: крокодилов
навык: навык
консо: консо
специальный: специально
например: например
удлиненного: удлиненного
такой: таких таким
отщепы: отщепы
полноценный: полноценных полноценные
обломки: обломка обломков обломки обломках
отрог: отрогов
насчет: насчет
сделано: сделано
животное: животных
использовать: использовали
делаться: делались
обработанного: обработанного
сопоставимый: сопоставимы
корявый: корявое
точка: точках
нижний: нижнее
десятилетие: десятилетий
млекопитающий: млекопитающих
заострять: заостряли
старый: старые
предположение: предположением предположение
принятый: принято
сообщить: сообщил
надежно: надежно
низменность: низменности
изготовлены: изготовлены
черта: черты
вместе: вместе
доступный: доступны
выветренные: выветренные
линейка: линеек
позволяющими: позволяющими
кость: кость костях
след: следы
рис: рис
видимый: видимому
отрезок: отрезков
оставить: оставить
размер: размеру размером
эффективный: эффективных эффективные
нескольких: нескольких
случайный: случайные
коллектив: коллектив
одинаковый: одинаковым
обучение: обучения
последовательный: последовательно последовательного
ядрищ: ядрищ
наибольший: наибольшим
сомнение: сомнений
плечевых: плечевых
различный: различных
притупленный: притупленный
пытаться: пытались
бифасы: бифасы
ранее: ранее
скрупулезно: скрупулезно
культурный: культурного культурном
ашельский: ашельский
краев: краев
уверенно: уверенно
бедро: бедра
изготовленных: изготовленных
лик: лики
эпоха: эпоху
рытьё: рытья
ретушированных: ретушированных
извлечь: извлечь
частность: частности
секрет: секретом
создать: создать
основный: основном
пройти: прошли
тесниться: теснятся
отборный: отборных
район: районах
бедренный: бедренную бедренных
свинья: свиней
уверенный: уверены
тяжелыми: тяжелыми
добывание: добывания
хищник: хищники
износ: износа
начать: начали
восточноафриканские: восточноафриканские
находка: находки находке находок
подвернувшейся: подвернувшейся
лучший: лучшей
полный: полные
ясный: ясным
датированном: датированном
сделанные: сделанные
достаточный: достаточно
источник: источник
общий: общие
распространение: распространением распространение
археологический: археологические археологический
рог: рогов
раскалывание: раскалывании раскалывание
эпизодический: эпизодические
стрелок: стрелками
яркий: яркий
опубликованной: опубликованной
число: числом числе
свидетельствовать: свидетельствуют
представляться: представляется
данные: данные
великобритания: великобритании
раннеашельскими: раннеашельскими
сохраняемости: сохраняемости
термит: термитов
извлечение: извлечения
археолог: археологов
проливать: проливают
полорогий: полорогих
направление: направления
отрывочный: отрывочными
многие: многие
наряд: наряду
найденных: найденных
заострен: заострен
идентифицировать: идентифицировать
классифицировать: классифицировать
пример: примера
примерно: примерно
оказываться: оказывались
слева: слева
предмет: предметы
раннеашельскую: раннеашельскую
использовались: использовались
целенаправленный: целенаправленной целенаправленно целенаправленного
нести: несут
справа: справа
раннепалеолитические: раннепалеолитические
очевидный: очевидно
ашельские: ашельские
плечевой: плечевой
возраст: возраст возрастом
поверхность: поверхности
распоряжение: распоряжении
рыхлый: рыхлой
ряде: ряде
комплекс: комплекса комплекс
деление: деление
юго: юго
кении: кении
некоторые: некоторых некоторые
подходящий: подходящего подходящих
разделка: разделки
изобретательнее: изобретательнее
большинство: большинство
эпифизу: эпифизу
костный: костного костных
усердие: усердием
настоящий: настоящие
аккуратный: аккуратно
красивый: красивые
ручных: ручных
находиться: находится
вода: воды
слоновий: слоновьих слоновьи слоновьей
найдено: найдено
первый: первую
результат: результате
улучшить: улучшить
редкость: редкостью
технология: технологий
больший: больших большие
проверка: проверку
длинный: длиннее
марков: марков
скудный: скудными
включать: включает
сообщество: сообщества
рубило: рубил рубила
очередь: очередь
соответствовать: соответствует
гоминиды: гоминиды
действие: действия
откалывая: откалывая
крупный: крупные крупных
обюдоострых: обюдоострых
древнейший: древнейшие
род: род
относительный: относительно
ашельских: ашельских
боковых: боковых
скорый: скорее
владеть: владели
предполагаться: предполагалось
название: названием
диафиза: диафиза
длина: длина длину
трещина: трещины
гиппопотам: гиппопотама гиппопотамы гиппопотамов
представленный: представлен
масштабный: масштабных
изготавливать: изготавливать изготавливали
наружный: наружного
эволюция: эволюции
острый: острый острых
похожий: похожих
предшественник: предшественников
человек: людей
путем: путем
позволять: позволяет
туш: туш
азия: азии
гиппопотамьи: гиппопотамьи
костя: кости костей
наличие: наличие
переход: перехода
фрагмент: фрагменты
подвергаться: подвергались
испания: испании
галька: галек
носорог: носорогов
разбирать: разбирают
экспериментальный: экспериментально
систематический: систематически систематическим
оставаться: остаются оставалось
место: месте
лезвие: лезвие
раскалывать: раскалывали раскалывают
новый: новый новыми
кортикального: кортикального
получаться: получается
жить: жили
искусственный: искусственно
отбивая: отбивая
гиппопотамьих: гиппопотамьих
александр: александр
обсуждаемой: обсуждаемой
исток: истоки
образ: образом
мастерить: мастерили
допускать: допускают
преимущественный: преимущественно
скелет: скелеты
свет: свет
орудийный: орудийной
широкий: шире широкой
каменный: каменные каменных каменными
согласоваться: согласуются
позволить: позволило
режущий: режущие режущий режущих
европа: европы
рыба: рыб
разнообразии: разнообразии
целый: целых целые
метода: методами
привлекать: привлекала
близкий: ближе
лошадь: лошадей
захоронение: захоронения
убедительный: убедительным
раннеашельского: раннеашельского
камень: камнями камня
пролить: пролили
деревянный: деревянные
расколотых: расколотых
помнить: помнить
конец: конец концах
касаться: касается
предназначение: предназначение
стандартный: стандартные
разделывать: разделывали
исключено: исключено
невыразительный: невыразительным
выглядеть: выглядит
олдувайском: олдувайском
обоюдоострый: обоюдоострых обоюдоострые
близость: близость
частица: частицами
группа: группы
изображение: изображения изображение
статья: статьи статье
точный: точными точно
этап: этапы
отличить: отличить
социальный: социального
приемами: приемами
костяной: костяные костяных костяное
использоваться: использоваться
сделаны: сделаны
добыча: добыче
вплотную: вплотную
миллион: миллион миллиона
непонятный: непонятно
эректусов: эректусов
изделие: изделий изделия изделие
искать: искали
верхний: верхнее верхнего
указывать: указывает
прямой: прямо прямой
сша: сша
многочисленный: многочисленных
взаимодействие: взаимодействие
трех: трех
показаны: показаны
возможный: возможно
естественный: естественных
откалывались: откалывались
мода: моды
человеческий: человеческой человеческих
репертуар: репертуаре
найдены: найдены
раннепалеолитических: раннепалеолитических
африканский: африканские африканских
присутствие: присутствие
слон: слона слонов
скол: сколов сколы
сохраняться: сохранялся сохраняются
ущелье: ущелье ущелья
пытаясь: пытаясь
затоплялась: затоплялась
править: правило
иначе: иначе
вроде: вроде
орудие: орудия орудий орудиями орудиях орудие
удар: ударов
олдувайского: олдувайского
оформлять: оформляли
наследование: наследования
сложный: сложной
журнал: журнале
сказать: скажешь
частить: части
впоследствии: впоследствии
разрозненный: разрозненные
франция: франции
отщепов: отщепов
заостренный: заостренный
передаваться: передавался
обработка: обработке обработки
толстокожий: толстокожие
слой: слое слоя
мочь: могли
гоминид: гоминид
эфиопия: эфиопии
обрабатываться: обрабатывались
вытеснить: вытеснить
гоминины: гоминины
отбивать: отбивали
однотипных: однотипных
убивать: убивали
грубый: грубо грубые
составлять: составляет
гораздо: гораздо
сохранившихся: сохранившихся
располагаться: располагаются
бифасов: бифасов
сюда: сюда
доступность: доступность
вдоль: вдоль
евразия: евразии
единичный: единичные
автор: авторы
утилизировать: утилизировали
рука: руку
учесть: учесть
расширять: расширяет
выйти: выйти
процесс: процессов
эректусы: эректусы
встречаться: встречаются
средний: средней среднем
изготовитель: изготовителями
известный: известно
изготавливаться: изготавливались
периодически: периодически
свежий: свежие
интерпретированные: интерпретированные
дизайн: дизайне
представление: представления
производство: производства
север: севере
танзании: танзании
примитивный: примитивными примитивные примитивных
предполагать: предполагают
край: край края
поэтому: поэтому
отметина: отметины
вероятный: вероятно
одном: одном
сформировался: сформировался
идентифицированных: идентифицированных
восточноафриканских: восточноафриканских
период: период
исследование: исследование
присутствовать: присутствуют
необработанный: необработанных
проверяться: проверялось
фриды: фриды
прочный: прочной прочного
грунт: грунта
млн: млн
ашельским: ашельским
последний: последних
начиная: начиная
отбивания: отбивания
культура: культуры
берцовый: берцовых
редкий: реже редко
случай: случаев
образоваться: образуется
тушить: туши
среди: среди
откалывания: откалывания
мелкий: мелкие
возникающие: возникающие
который: которыми
мозг: мозга мозг
сохраниться: сохранились
тупой: тупой
друг: друг другу
падаль: падаль
раннеашельский: раннеашельский
элемент: элементы
образующихся: образующихся
местонахождение: местонахождении местонахождение местонахождения
приречной: приречной
