друг: друг друга
приносить: приносили
реплицироваться: реплицироваться
целакантов: целакантов
отделиться: отделилась
технология: технологии
выделяющийся: выделяющееся
постарайтесь: постарались
искусственный: искусственному искусственно
ветвления: ветвления
трех: трех
гомологами: гомологами
придаток: придатки
разделение: разделения
ампутация: ампутации
сохранить: сохранил сохранили
сходство: сходство
невымершие: невымершие
вероятный: вероятно
судить: судят судить
показатель: показатели
теоретический: теоретический
максимальный: максимальном
современный: современных современные современного современными
статья: статьи статья статье
исследовательский: исследовательским
прочтенных: прочтенных
тема: теме
считаться: считается
узел: узлов
переполненные: переполненные
складываться: складываться
отсутствовать: отсутствует отсутствуют
суметь: сумеет
вымирание: вымирания
наследие: наследие
момент: момента момент
прочтенные: прочтенные
гигабаз: гигабаз
окостеневать: окостеневают
включаться: включался
передне: передне
понижена: понижена
посвящена: посвящена
развиваться: развивается развиваться
элемент: элементов элемента элементы элементами
геномных: геномных
молекула: молекул
синтезированные: синтезированные
независимый: независимо независимых
увеличиваться: увеличиваться увеличивался
сообщаться: сообщалось
поддержать: поддержал
факторов: факторов
история: история историю
хрящевые: хрящевые
горилла: гориллой
американский: американский американским
понимание: понимании
клетка: клеток клеткам
организм: организм
деградация: деградация
латимерию: латимерию
рассказано: рассказано
ретротранспозоны: ретротранспозоны
исключено: исключено
место: месте
алан: алана
эволюционный: эволюционное эволюционных эволюционные эволюционная эволюционную
участок: участков участки
утрата: утратой утрата
одна: одна
принадлежащий: принадлежащего
эпоха: эпохи эпох
изредка: изредка
безумный: безумные
австралийский: австралийского австралийский
показать: показало показал показали показать
тиреоидной: тиреоидной
ткань: ткани
объяснять: объясняют объясняет
работающий: работающий
жизнь: жизни
внешний: внешнее
метода: методы методами
исчерпывающий: исчерпывающий
регуляторных: регуляторных
чешуйчатник: чешуйчатник
прочтение: прочтении
кодирующих: кодирующих
курица: курицы
массовый: массового
обоих: обоих
участвовать: участвуют
предполагаться: предполагается
показано: показано
связано: связано
мгэ: мгэ
разобраться: разобрались
похожий: похоже похожие похожи похожа похожее
сопровождаться: сопровождалось
легких: легких
уместный: уместно
вопрос: вопрос
видный: видно
пришелся: пришелся
отличаться: отличаются
большой: большой
черед: черед
коллектив: коллективом коллектив
другой: другом другими другим
частность: частности
множество: множества
млн: млн
изображение: изображения
примитивный: примитивное примитивный
стадия: стадий
африканский: африканского африканский африканских
характерный: характерных характерны
хромосомных: хромосомных
ретрокопии: ретрокопии
легкое: легкое
млекопитающий: млекопитающих
аксолотля: аксолотля
иметь: имеет
редуцирована: редуцирована
черта: черты
кстати: кстати
общий: общему общего
рука: руках
хромосома: хромосомы хромосомах хромосом
марков: марков
интересный: интересный интересно интересных интересную
оказаться: оказались оказалось
неоцератода: неоцератода
земной: земной
изучение: изучение изучении изучения
сайт: сайтов
хрящ: хрящи хрящами
биолог: биологами
повезти: повезло
последовательность: последовательность последовательностями последовательности
прежнему: прежнему
сильный: сильно
животное: животных животного
одном: одном
тремя: тремя
европейско: европейско
копия: копии копией
интересующее: интересующее
консервативность: консервативность
ближайший: ближайшие ближайшего
такой: такую такого таким таких
собственный: собственно
говориться: говорится
важнейший: важнейший
идея: идеи
антропогенеза: антропогенеза
основание: оснований
нечто: нечто
экспрессия: экспрессию
обязательный: обязательно
проаннотированные: проаннотированные
обнаружены: обнаружены
предплечье: предплечья
остальное: остальные остальных
последний: последние
вид: видов вида
видимый: видимому
расшифровать: расшифровать
представленный: представлены
рогозуб: рогозуб
найдена: найдена
относительный: относительно
удаление: удалении
слева: слева
родственный: родственные
южноамериканский: южноамериканского южноамериканский южноамериканскому
ретрокопия: ретрокопия
содержаться: содержится
гора: горы
мышь: мыши мышах
точка: точек
найти: найти
преаксиальные: преаксиальные
сразу: сразу
клеточный: клеточных
появиться: появились
исследование: исследованиях
первый: первых
громадный: громадный
требовать: требует
родственник: родственники родственника
обсуждаемая: обсуждаемая
делиться: делиться
разнообразия: разнообразия
дошел: дошел
аналитический: аналитических
совершенный: совершенно
разрастаться: разрастаться
хвостовой: хвостовой
сохранившихся: сохранившихся
конечность: конечностей конечности
тип: типов
воспрепятствовать: воспрепятствовал
транскрипции: транскрипции
генный: генных
насчитываться: насчитывалось
гигабазы: гигабазы
изучить: изучили
должный: должен должны
основа: основе
рнк: рнк
название: названиями
человеческий: человеческий человеческих
произойти: произошло
подтвердить: подтвердил подтвердили
строй: строя
обнаружено: обнаружено
нужный: нужный нужном
меняться: менялась
поздний: позднее
чувствительность: чувствительность
малый: малых малый
являться: являются
костный: костных костной
связь: связи
интронов: интронов
изображенные: изображенные
поскольку: поскольку
днк: днк
разный: разных
признак: признаков
группа: групп группы
легкие: легкие
пар: пар
белка: белок
понижено: понижено
нижний: нижней
пирнк: пирнк
лепидосирену: лепидосирену
хозяйский: хозяйский хозяйские хозяйских
продолжать: продолжают
гораздо: гораздо
неотенические: неотенические
своевременный: своевременное
конец: конце
ареал: ареалы
повторяющиеся: повторяющиеся
превратиться: превратились
мочь: могла
ранний: ранних
ожидать: ожидать
превращение: превращения
упроститься: упростились
прослежена: прослежена
частить: части
обсуждаемой: обсуждаемой
суперконтинента: суперконтинента
взрослый: взрослого
реконструировать: реконструировать
путь: путь
объяснить: объяснить
интригующий: интригующая
накапливающихся: накапливающихся
начинать: начинал начинает
меловые: меловые
отдельность: отдельности
указывать: указывает
активный: активен
изменены: изменены
четвероногий: четвероногих
разрастание: разрастанием разрастание разрастанию
собранный: собранные
число: число числа
какой: какое какого какие какую
помочь: помог помогли
разнообразие: разнообразие
неоднократный: неоднократно
палец: палец пальцев
человек: человека человеку
подобный: подобно подобных
фермент: ферменты
проводиться: проводились
образ: образом
вред: вреда
развитие: развития
строгий: строго
причина: причины причину
неотенических: неотенических
возникновение: возникновения
мизинец: мизинец
размер: размер размера размеров размере размеру
отчасти: отчасти
центральный: центральной
рис: рис
скелетные: скелетные
встраивать: встраивать
рогозубом: рогозубом
вероятность: вероятность
изменение: изменениями изменение
фон: фоне
дупликаций: дупликаций
ход: ходе
выйти: вышла
голень: голени
особенность: особенность
включая: включая
коррелируют: коррелируют
сравнительный: сравнительной
серый: серые
глубокий: глубоком
повреждение: повреждение
педоморфоз: педоморфоз
оси: оси
рекордный: рекордное
протоптеров: протоптеров
происходить: происходит
ящерица: ящерицы
средний: среднем
конкретный: конкретной
объект: объект
функциональные: функциональные
измениться: изменились
род: родов родами рода
отношение: отношения
больший: большими
активность: активность активности
сравнение: сравнения сравнению
развивающийся: развивающемся
сверхконсервативного: сверхконсервативного
главный: главный
остеоцитов: остеоцитов
автор: авторы авторам
происхождение: происхождения происхождение
сдерживать: сдерживало
рубеж: рубеже
разделиться: разделились
анализ: анализа анализе анализ
доложить: доложил
итог: итоге
счет: счет
хвостатый: хвостатых
энхансера: энхансера
лепидосиреном: лепидосиреном
контроль: контроля
упрощение: упрощения упрощении
гигантский: гигантский гигантскими гигантских гигантским
утрачены: утрачены
подробный: подробно
многие: многие
вставка: вставки
симметричный: симметричный
ретрокопий: ретрокопий
справляться: справляется
странный: странные странно
протоптер: протоптер
опыт: опыты
птичий: птичьих
защитный: защитных
потенциальный: потенциально
тьюринга: тьюринга
исходный: исходное исходного исходный
пролить: пролить
секвенирования: секвенирования
цитировавшейся: цитировавшейся
обзор: обзор
обратный: обратной
зона: зоне
эксперимент: экспериментах эксперименты
геном: геномов геномами геномам генома геномы геноме геномах геномом
подробнее: подробнее
норма: норме
радиальный: радиальные
оставаться: остаются
размножаться: размножаться
ранее: ранее
обычный: обычное обычный обычного обычному
понятный: понятно понятное
тетрапод: тетрапод
закономерность: закономерностях
подтвердиться: подтвердилось
подконтрольный: подконтрольный
измельчать: измельчали
объяснение: объяснение
кодируемые: кодируемые
энхансеров: энхансеров
отсеквенировал: отсеквенировал
самый: самый самые
вывод: выводом выводы
номер: номер
уровень: уровня
совершенствоваться: совершенствуются
точный: точные
филогенетического: филогенетического
сохраниться: сохранились
сохраняться: сохраняется
геномики: геномики
нормальный: нормального
настоящий: настоящая
огромный: огромные огромного огромный
неуклонный: неуклонно
трансгенных: трансгенных
неотения: неотения
перестраиваться: перестраивается
легочные: легочные
оценка: оценки
хороший: хороший
гипофизарно: гипофизарно
отсутствие: отсутствием
осмыслить: осмыслит
наземный: наземных
включение: включение
регуляторного: регуляторного
работа: работе
век: века
рыба: рыб
ген: генов гена геном генами гены ген
механизм: механизм механизмов
луч: лучей
конкретику: конкретику
либо: либо
редуцироваться: редуцировалась редуцировались
увеличение: увеличением увеличение увеличения
плавник: плавников плавники плавник плавника плавнике плавником
карбона: карбона
отсеквенированных: отсеквенированных
слово: слову
позвоночный: позвоночных позвоночные позвоночными
шкала: шкала
движение: движении
миллиард: миллиардов
гигабазным: гигабазным
править: правило
хорда: хорда
рисунок: рисунок рисунке рисунка
вторичный: вторично
китайский: китайскими
качественно: качественно
цифра: цифр
плавниковых: плавниковых
регенерирующим: регенерирующим
специальный: специальных
нитевидный: нитевидные
примерно: примерно
раскол: раскола
нога: ноги
исследователь: исследователей
ретротранспозонами: ретротранспозонами
простой: простое
рогозуба: рогозуба
зачаток: зачатке зачатка
активировать: активировать
сыграть: сыграла
палеозойский: палеозойскими
анатомия: анатомии
недавний: недавние
объясняющие: объясняющие
ослаблено: ослаблено
полагаться: полагается
сигнальный: сигнальный
бесконтрольный: бесконтрольным бесконтрольно
ретротранспозонов: ретротранспозонов
играть: играют
сотня: сотни
новость: новости новостях
поздно: поздно
получаться: получается
прошел: прошел
отражать: отражают
древние: древних древними
например: например
высокий: высокого
полностью: полностью
большинство: большинство
лепидосирена: лепидосирена
регулятор: регуляторов регулятор
успешный: успешном успешно
управление: управления
состав: состав
амфибий: амфибий
морфология: морфология морфологии
течение: течение
одним: одним
способствовавших: способствовавших
парный: парных парные парном
гондвана: гондвана
найдены: найдены
повторяющимися: повторяющимися
кость: костях
скелет: скелета
гипоталамо: гипоталамо
мрнк: мрнк
геологический: геологическая
важный: важных важную
отличающийся: отличающаяся
необходимый: необходимых необходимы необходим
одну: одну
сохранение: сохранение
нескольких: нескольких
полость: полостей
положенный: положено
ископаемое: ископаемых
деление: делений делением
строение: строении
извлечь: извлечь
удалось: удалось
суша: сушу
план: плане
пояснить: пояснить
ответ: ответ
получиться: получилось получиться
данные: данных
расположение: расположения
войти: вошли
система: система системы системе систем
помощь: помощи
помогающие: помогающие
отбор: отбор
низший: низших
смешной: смешные
запястье: запястья
включать: включает
размножение: размножением размножения
вверху: вверху
укрощение: укрощении
перестройка: перестроек
утратить: утратили
динозавр: динозавров
транспозонами: транспозонами
боковые: боковые
потерять: потеряли
чешуя: чешуи
пытаться: пытаются
вставлять: вставлять вставляют
согласоваться: согласуется
отвечать: отвечает
случай: случая случаях
учеными: учеными
понять: понять поймёт
космин: космин
знать: знаем
расцвет: расцвет
навсего: навсего
событие: события
лучить: лучи
александр: александр
неопределенность: неопределенность
достигать: достигали
непосредственный: непосредственные непосредственную
допустить: допустил
облик: облику
постаксиальные: постаксиальные
линия: линия
очередь: очередь
сравнить: сравнить
эволюция: эволюции эволюцию эволюция
некодирующих: некодирующих
каждый: каждой каждым
контролировать: контролировать контролирует
ограничение: ограничения
обзавестись: обзавелась
основы: основы основах
задача: задачей
объясняться: объясняется
девонский: девонский
проверить: проверили
снимать: снимает
новшество: новшеств
сверхразуму: сверхразуму
дерево: дерево дерева
двоякодышащие: двоякодышащих двоякодышащие двоякодышащими двоякодышащим
полярность: полярности
постоянный: постоянно
возникать: возникают
отражены: отражены
мутация: мутаций
стать: стали
производство: производство
заметить: заметим
мясистый: мясистых мясистые
вообще: вообще
молекулярный: молекулярных
маленькая: маленьких
задний: задней задние
источник: источник
холмик: холмики
быстрый: быстро быстрее быстрого быстрых
истинный: истинные
прослеживаются: прослеживаются
работать: работают
мобильный: мобильных мобильными
обезвреживания: обезвреживания
второй: втором
эгоистичный: эгоистичной эгоистичных
отделение: отделения
кайнозоя: кайнозоя
путем: путем
результат: результате
бурый: бурый
трудный: трудно
шимпанзе: шимпанзе
артерия: артерии
латимерии: латимерии
основный: основном основные
количество: количество
справа: справа
показывающее: показывающее
предок: предков предки предками предка
выясниться: выяснилось
расплодиться: расплодились
правда: правда
ниточка: ниточки
предплюсна: предплюсны
девон: девона
вдвойне: вдвойне
непомерный: непомерным
часть: частей
редукция: редукция редукцию
мешать: мешает
датировка: датировок
свет: свет
метод: методов
фантастический: фантастические
ничем: ничем
разрастись: разрослись
биология: биологии
обладатель: обладателя
лапа: лапы
август: августе
накопленные: накопленные
консервативный: консервативные
метаморфоза: метаморфоз
повышать: повышает
собака: собаки
технический: технические техническое
каскад: каскад
выход: выхода
роль: роль
представитель: представители представителя
непарный: непарное
состояние: состояние
изучать: изучать
одинаковый: одинаковыми одинаковые
новый: новых новые
протоптера: протоптера
период: период
называемых: называемых
создание: создания
грядущий: грядущих
генетический: генетических генетические генетическими
насколько: насколько
