скала: скалы
следовать: следовать
дромеозаврид: дромеозаврид
сравнительный: сравнительно сравнительную
корее: корее
предпринимались: предпринимались
бегающих: бегающих
подобный: подобно
достигать: достигала
миновать: миновать
линейный: линейным
вдоль: вдоль
костя: кости
активный: активному активно активного
время: временем
вполне: вполне
китай: китая
сохранившихся: сохранившихся
разобраться: разобраться
берег: берега берегом
бежать: бежал бежать
запачкать: запачкать
крыть: крыла
прочить: прочь
бедро: бедра
прыгать: прыгать
прыжок: прыжки прыжка прыжков
день: дня
судя: судя
различный: различных
взбегая: взбегая
перемещение: перемещения
оценка: оценкой оценки
создание: создании
перо: перья
вариант: вариантов
дорожка: дорожка дорожку дорожки
достигнуть: достиг
трижды: трижды
возвышенность: возвышенность
определенным: определенным
высокий: выше
завеса: завесу
минимум: минимум
обнаруживать: обнаруживать
трех: трех
расчетам: расчетам
ракета: ракета
множество: множества множество
полету: полету
птенец: птенцы
сила: силу силы
одними: одними
вместе: вместе
такой: такого таких
чинджу: чинджу
незначительный: незначительное
подробный: подробный
планирующих: планирующих
увидеть: увидели
внешний: внешний
поведение: поведении поведения
предполагаемый: предполагаемых предполагаемую
пернатый: пернатых пернатые
птица: птиц птицы
мочь: могли
ящер: ящеры ящеров
доисторический: доисторического доисторических
семи: семи
двигаясь: двигаясь
искусственный: искусственно
угол: углом
эффективнее: эффективнее
жертва: жертв жертву
приходиться: приходилось
беречь: берегу
подъемной: подъемной
следовой: следовая следовую следовые следовой
участок: участок
слева: слева
избегать: избегать
статья: статьи
принадлежать: принадлежат
несся: несся
элемент: элементы
второй: вторых вторая
гипотеза: гипотезы гипотезе гипотез
одни: одни
задний: задней
должный: должны
детеныши: детеныши
оказаться: окажись
тема: темы
встречаться: встречались
внимание: внимание
примитивный: примитивного
принадлежащий: принадлежащие
прыгающая: прыгающая
исключать: исключает
засада: засады
мокрый: мокрому мокрый
создатель: создателем
убегающую: убегающую
горизонтальный: горизонтальной
какой: каким
приводить: приводить
развиться: развилась
настигнуть: настигнуть
возможный: возможно
догонять: догоняли
конечность: конечностей конечности конечностями
ящерица: ящериц
маленькая: маленьких
фотография: фотографии
ихнофоссилии: ихнофоссилии
крохотный: крохотными крохотное крохотный
сантиметр: сантиметра
дело: деле
среда: среде
канада: канады
адаптированных: адаптированных
способность: способность
быстрый: быстрее быстро
превосходить: превосходят
известный: известных известное
чрезвычайный: чрезвычайно
рыбоядные: рыбоядные
бить: били
пропорция: пропорций
источник: источник
загадка: загадок
воссоздавать: воссоздавать
попытка: попытки
дожидаясь: дожидаясь
составлять: составляли составляла
порода: породы
оставить: оставил оставить
модель: модели модель
крутой: крутым
бегун: бегунами
повезти: повезло
необычный: необычную
отличаться: отличаются
высота: высоту высота
новость: новости
полагать: полагают
промежуточный: промежуточных
новиковская: новиковская
озерному: озерному
животное: животных животного животные животными животное
создавая: создавая
благодаря: благодаря
нелетающих: нелетающих
динозавр: динозавр динозавра динозавров динозавры динозавром динозаврами
земля: земле
возникновение: возникновение возникновения
набрасываться: набрасываться
оставленный: оставленную оставленных
формация: формации
обратить: обратите
сайт: сайта
забравшись: забравшись
нога: ног ногах
завязнуть: завязнуть
прыгающего: прыгающего
плоскость: плоскости
момент: момента
совершая: совершая
погоня: погоне
совершать: совершали
сложный: сложной
доказательство: доказательства
международный: международной
одним: одним
произойти: произойти произошли
прийти: прийти
самый: самых самыми
больший: большие
расстояние: расстояния расстояние
спастись: спастись
мелкий: мелкого мелкие мелких мелким
предок: предков предки
группа: группе
примерно: примерно
зайдя: зайдя
помощь: помощи помощью
реальный: реальный
перепархивающих: перепархивающих
линия: линий
крыло: крыльев крылья крыльями
картинка: картинку
планета: планете
страус: страус
оценить: оценить оцените оценили
вряд: вряд
одна: одна
начало: начале
приподнять: приподнять
южный: южной
подтверждать: подтверждает
бегающие: бегающие
предложены: предложены
современный: современных современные
бегающая: бегающая
подсемейство: подсемейства
вид: вид виды
учетом: учетом
обсуждаемых: обсуждаемых
длинный: длиннее длинные длинным длинных
прорисовка: прорисовка
жизнедеятельность: жизнедеятельности
наземный: наземных наземное
согласный: согласно
подкарауливать: подкарауливали
найденным: найденным
возможность: возможности
исследование: исследование
лазающие: лазающие
птичий: птичьего птичьи
бегать: бегать
хищник: хищников
увеличить: увеличить
завышенной: завышенной
вероятный: вероятно
скорость: скорость скорости
эффективный: эффективными эффективным
взмахивать: взмахивал
бег: бега
найдено: найдено
любой: любые любое
мезозойский: мезозойской
объяснить: объяснить
век: века
постоянный: постоянным
изучить: изучить изучили
присутствие: присутствие
ученым: ученым
длина: длины длину длиной
полета: полета
отпечаток: отпечаткам отпечаток отпечатки отпечатков отпечатками отпечатка
весь: всей
остается: остается
анна: анна
поведать: поведать
ихнотаксону: ихнотаксону
смочь: смогли смогло
четырехкрылыми: четырехкрылыми
шустрый: шустрого шустрых
лазать: лазать
важный: важна
приходить: приходят
рисунок: рисунок
отложение: отложениях
промежуток: промежутки
аномальный: аномально
передний: передних передними
передвижение: передвижения
выдавать: выдавал
четырех: четырех
предшественник: предшественников
склон: склонам
обсуждаемой: обсуждаемой
постарайтесь: постарался
ученые: ученые
позволить: позволила
исходя: исходя
древесный: древесные древесная
микрораптор: микрораптор
аэродинамический: аэродинамическую
образ: образом
вымерший: вымерших
перейти: перейти
планирующие: планирующие
оперенными: оперенными
преувеличение: преувеличение
окаменевший: окаменевшие
ткань: ткани
размер: размеров размерами
добыча: добычей
появиться: появились появилась
забираясь: забираясь
процесс: процессом
независимый: независимо
хищный: хищный хищного хищным хищных
эра: эры
среди: среди
конец: конце
обнаружена: обнаружена
столь: столь
близкий: ближе
тайный: тайны
ископаемое: ископаемые
исследователь: исследователей исследователи
четвероногий: четвероногое
перемещаться: перемещался
оперенных: оперенных
маленький: маленький
который: которым которыми
восхождение: восхождениям
отражать: отражает
строение: строения
серия: серией
пробежав: пробежав
разбор: разбор
переходить: переходили
четырехкрылый: четырехкрылый
подходящий: подходящего
представитель: представителю
микрорапторин: микрорапторин
пласт: пласт
найденная: найденная
автор: авторы
интересный: интереснее
помогать: помогают помогали
преодолевать: преодолевать
проависа: проависа
летающих: летающих
стать: стали
жить: жить
сша: сша
глубина: глубины
эволюционный: эволюционных
летать: летать
общий: общей
оперение: оперение
дерево: деревьям деревьев деревьями
использовать: использовали
первый: первых
использование: использования
гепард: гепард
вывод: выводу
научиться: научились
ствол: стволы
кореи: кореи
соотношение: соотношению
динозаврик: динозаврик
ветка: ветки ветку
несущихся: несущихся
объясняющие: объясняющие
путь: путь
след: следы следов следами
микрораптору: микрораптору
предложена: предложена
предположительно: предположительно
сохранившийся: сохранившийся
работа: работе
крупный: крупных
мягкий: мягкие
позволять: позволяют позволяло
шаг: шага шаги шаг шаге шагов
число: числе
грязь: грязи
удлиненные: удлиненные
приблизиться: приблизиться
озеро: озера
