механизм: механизма
неподалеку: неподалеку
повреждение: повреждении
комната: комнате
богатый: богатая
время: временем
ожидать: ожидать
анализ: анализ анализа
свежесть: свежести
копролитах: копролитах
семя: семенами семена
образовать: образуют
эндемики: эндемики
ранний: ранней
ехать: еду
случай: случаях случаев
отражать: отражает
элемент: элементы
отпечаток: отпечатков
высокий: высокую
сыроежка: сыроежка сыроежки
небольшой: небольшой
базидиомицеты: базидиомицеты
свободный: свободном
четырьмя: четырьмя
вопрос: вопрос
другой: другими
исчезновение: исчезновения
косвенно: косвенно
сторона: сторону
микофагов: микофагов
плод: плодами плод плоды
южный: южного южном
такахе: такахе
образ: образом
разный: разных
остров: острове
диапазон: диапазон
формируется: формируется
нелетающего: нелетающего
альпийский: альпийскими
изученного: изученного
адаптироваться: адаптировались
сочный: сочные сочными
шлемоносный: шлемоносный
составлять: составляет
завезенные: завезенные
питаться: питались питаться питался питаются
ним: ним
обладать: обладают обладали
исчезнуть: исчезли
агарикоидные: агарикоидные
обсуждаемой: обсуждаемой
дело: деле дело
количество: количество
сосна: сосна
собранный: собранные
система: системой
окраска: окраской окраски
питание: питанию
широкий: широко
эктомикоризными: эктомикоризными
преобладать: преобладали преобладала
пещера: пещере пещеры пещера
четвертого: четвертого
долгосрочный: долгосрочные
способность: способности
спутник: спутников
роль: роль
растительный: растительно
основа: основе
тонкосемянником: тонкосемянником
становиться: становится
определенной: определенной
определить: определить
эму: эму
подстилка: подстилке
мегафауны: мегафауны
момент: момент
исследовательский: исследовательского
маори: маори
диета: диет диета
видимый: видимому
например: например
макроскопический: макроскопические
угроза: угрозой
таксономического: таксономического
пищать: пищу пищи
обоих: обоих
напоминать: напоминает
многие: многие
пернатый: пернатые
трещина: трещинах
растительность: растительностью
называемый: называемый
подокарповых: подокарповых
меняться: менялись
разрешение: разрешения
принадлежать: принадлежали
использовать: использовали
среди: среди
иметь: имеют имели имеет
размножаться: размножаются
рост: роста
материал: материалов
лабораторный: лабораторные
темп: темпов
травоядный: травоядных травоядные
экскремент: экскременты
трюфелька: трюфелька
считаться: считается
фиолетовый: фиолетовую фиолетовой
консервация: консервацию
пример: примеров примеру
весившей: весившей
сбор: сбора
ген: ген
микоризообразователи: микоризообразователи
ветер: ветром
размер: размер
испражняясь: испражняясь
распространение: распространения распространению распространении
сравнить: сравнил
манукой: манукой
включать: включало
малый: малого малую малому малый
вымирание: вымирания вымирании вымирание
инвазивных: инвазивных
распространяться: распространялись
среда: среды среду
похожий: похожие
соскребли: соскребли
гондваны: гондваны
стадия: стадии
состав: состава
минимизировать: минимизировать
идентификация: идентификации
оставшееся: оставшееся
трюфелепоодобных: трюфелепоодобных
копролиты: копролиты
обязательный: обязательно
обнаружены: обнаружены
дата: даты
поеданием: поеданием
запах: запаха
отсутствовать: отсутствуют
возможный: возможны
юг: юге
древний: древней
средний: среднее
аналог: аналогов
видовой: видового
задумываться: задумываются
преимущественный: преимущественно
помощь: помощи помощью
взять: взяли
единственный: единственными
всеядный: всеядных всеядный
оценить: оценить
существование: существование
распространяющих: распространяющих
обнаружена: обнаружена
синеть: синей
пологий: полог
местный: местных местные
теория: теории
смещение: смещению
рамка: рамках
образующие: образующие
служить: служит
особь: особи
перекрывания: перекрывания
воздействие: воздействие
получать: получают получали
обломки: обломками
извлечение: извлечении
обе: обе
казуар: казуар
исследование: исследование исследовании исследований
экосистема: экосистеме экосистемах
взаимосвязанный: взаимосвязаны
австралия: австралии австралией
дерево: деревьев деревьями
способствовать: способствовало способствовать
численность: численность
эктомикоризу: эктомикоризу
английски: английски
лесной: лесного лесному лесной
лес: лесов леса лесах лесом лесами
совымирание: совымирание
новозеландских: новозеландских
копролитов: копролитов
остеологический: остеологические
приспособлены: приспособлены
ряд: ряд
ориентироваться: ориентируются
животный: животно
прибытие: прибытия
справочный: справочную
образование: образования
лорд: лорд
новозеландские: новозеландские
статья: статьи статье
ареал: ареал
исследовать: исследовали
желудок: желудков
тело: телами тела
цепочка: цепочки
предположить: предположить
научный: научно
некодирующей: некодирующей
увеличение: увеличении
дальнейший: дальнейших
лежащий: лежащий
место: места местах
петроика: петроика
риск: риск
мелкий: мелкой
привести: привело привести
цветной: цветным цветные
видеть: видели
остальное: остальными
замечены: замечены
каледонии: каледонии
точка: точкой
больший: большие большая больший
трюфелеподобными: трюфелеподобными
использовались: использовались
оставить: оставили
встречаться: встречаются
преимущество: преимущество
содержать: содержат
хозяин: хозяевам
человек: человека
корень: корнями корней
день: дня
продуктивность: продуктивности
пушистый: пушистых
существенный: существенную
фото: фото
такой: таких таким
связанный: связанных
первый: первую первой
интродуцированные: интродуцированные
конец: конце
прохождение: прохождением прохождения
бывший: бывшие
микофаги: микофаги
совымиранием: совымиранием
подтвержденных: подтвержденных
бескилевые: бескилевые
трюфелеподобных: трюфелеподобных
плейстоцен: плейстоцена
светлый: светлой
нотофагусом: нотофагусом
копролита: копролита
зеландии: зеландии
характерный: характерный
новозеландскими: новозеландскими
опорожнять: опорожняет
млекопитающий: млекопитающих млекопитающими млекопитающие
уязвимый: уязвимый
граница: границы
осадка: осадке
база: базу
шляпка: шляпкой
патагонии: патагонии
рис: рис
картинка: картинку
относиться: относятся
трюфели: трюфели
страдать: страдать
исключены: исключены
съесть: съели съесть
морфология: морфологии
воробьиный: воробьиной
симбионты: симбионты
далекие: далекие
преобладание: преобладанием
дополнительный: дополнительных
имеющий: имеющие
вызванный: вызванного
внутри: внутри
понять: понять
степень: степень
канукой: канукой
тысячекратном: тысячекратном
попадание: попадание
род: родов рода
поэтому: поэтому
густой: густым
субальпийской: субальпийской
симбиоз: симбиоз
аборигенных: аборигенных
гипотеза: гипотезе
полагать: полагают
обычный: обычны обычен
логичный: логично
неслучайное: неслучайное
искать: искали
кузу: кузу
юлия: юлия
лесообразующими: лесообразующими
крупный: крупными крупного крупной крупных крупные
название: названию
амплифицировали: амплифицировали
какой: какого
северный: северный северная
далеком: далеком
есть: ели едят
организм: организм
сливовый: сливовая
источник: источник
посредство: посредством
ученые: ученые
меловом: меловом
распространяемых: распространяемых
изучены: изучены
попадать: попадает
вполне: вполне
резюмируя: резюмируя
известный: известно
называть: называют
предсказывать: предсказывает
растение: растений растения растениями
предстоять: предстоит
обитание: обитания
часы: часов
сохранившейся: сохранившейся
таксонов: таксонов
агарикомицеты: агарикомицеты
помнить: помним
спор: спор споры спорами
успешный: успешно
попугай: попугая
разнообразие: разнообразие
вид: виды видами видов вида виду вид виде
насекомое: насекомых
испражнившихся: испражнившихся
регион: регионах
пахучий: пахучие
бархатный: бархатной
значительный: значительные
перемещаться: перемещался
новый: новой новое
нелетающие: нелетающие
наименее: наименее
трехсторонний: трехсторонний
жкт: жкт
основный: основном основных
мутуализм: мутуализм
позволить: позволило
ходжес: ходжес
плохой: плохо
ориентирующимися: ориентирующимися
недостаточный: недостаточно
правда: правда
живущий: живущие
почва: почвы
повлечь: повлечь
массовый: массового
питательный: питательную
прекрасный: прекрасным
опыляющих: опыляющих
частить: части
исключено: исключено
будучи: будучи
распространитель: распространителями
пищеварительный: пищеварительной
днк: днк
лаборатория: лаборатории
идентифицированных: идентифицированных
разнообразный: разнообразной
джаред: джаред
агарикомицетов: агарикомицетов
общий: общие
каскад: каскад
долг: долг
стерильный: стерильным
минута: минут
осадком: осадком
скала: скал
безлесный: безлесных
ученых: ученых
птица: птицами птиц птицы птице птицей
фауна: фауне
грибной: грибной грибных грибные
окруженных: окруженных
микромицетов: микромицетов
удачный: удачно
совокупность: совокупности
серый: серо
нотофагусовые: нотофагусовые
какапо: какапо
велик: велика
привлекать: привлекать
всадник: всадниками всадника
разрушение: разрушение
очередь: очередь
колонизировать: колонизировать
низкий: низка
даймонд: даймонд
быстрый: быстрой быстро
проверяться: проверялось
район: районов
фьордленде: фьордленде
часть: часть
скальпель: скальпелем
орнитофауна: орнитофауна
язык: языке
концентрация: концентрация
включая: включая
число: числе
паутинник: паутинник
затронуть: затронут
участок: участок
рептилия: рептилии
вступающие: вступающие
рацион: рационе
чрезмерный: чрезмерная
назвать: назвать
мочь: могли
отправной: отправной
эктомикоризные: эктомикоризные
отсутствие: отсутствием
королевский: королевского
учреждение: учреждений
сапротрофных: сапротрофных
образующими: образующими
координаты: координат
нотофагуса: нотофагуса
благородный: благородный
ярка: яркой
трюфелеподобные: трюфелеподобные
метр: метрах
переваривание: переваривание
угрожать: угрожает
работа: работы
функциональных: функциональных
михневич: михневич
наземный: наземными наземных наземные
причина: причинами причины
комменсалам: комменсалам
собственный: собственно
яркий: ярких яркие ярко
последствие: последствия последствий
картошка: картошкой картошку
паутинников: паутинников
биолог: биолог
знать: знаем
пастушок: пастушок
выявить: выявил
крик: крик
позвоночный: позвоночных
адаптированы: адаптированы
расстояние: расстояния
группа: групп
стабильность: стабильности
трюфелей: трюфелей
присутствовать: присутствовал
шишка: шишками
играть: играть
ключевой: ключевого
развиваться: развиваются
вкусить: вкусить
найден: найден
инвазивными: инвазивными
сразу: сразу
коричневый: коричневые
надземный: надземные
показывать: показывает показывают
экологический: экологические
образец: образцах образец образце
копролит: копролит
кластер: кластеры
симбионтам: симбионтам
расселяться: расселяться
выборка: выборки
важный: важны важнее
формирование: формирования
способствуя: способствуя
самый: самые
окружена: окружена
ультрафиолетом: ультрафиолетом
орнитофауны: орнитофауны
апокалипсис: апокалипсиса
поедающих: поедающих
процесс: процесс
охота: охота
коллега: коллегами
вышесказанный: вышесказанное
покрытый: покрытый
определять: определяли
микроскоп: микроскопом
клетчатка: клетчаткой
десяток: десятки
настоящий: настоящее настоящий
получиться: получилось
непреднамеренно: непреднамеренно
доля: доля
гигантский: гигантские гигантского
редкий: редко
музей: музея
уэка: уэка
пищеварение: пищеварения
большинство: большинство
наличие: наличие
специфичных: специфичных
одновременный: одновременно
вряд: вряд
зовется: зовется
доказательство: доказательствами
частичка: частичками
плодовый: плодовыми плодовые плодового
антропогенными: антропогенными
фрукт: фрукты
облучили: облучили
длительный: длительным
дальний: дальние
процедура: процедуры
изучение: изучение
опосредованно: опосредованно
представлять: представляют
исследованный: исследованных
страус: страуса
отмечать: отмечал
эмпирический: эмпирически
анахронизм: анахронизмов анахронизм анахронизмы
адаптация: адаптацию
вымереть: вымерло вымерли
предназначенный: предназначенной
убедительный: убедительными
подземный: подземные
внутренний: внутренней
пережить: пережить
доминировать: доминируют
гриб: грибов грибы грибами грибах гриба
показать: показало
вероятный: вероятно
паразит: паразитам паразит
контаминация: контаминации
лисий: лисий
вегетативный: вегетативно
нотофагусовым: нотофагусовым
течение: течение
луг: лугами
моа: моа
животное: животные животных животными
современный: современной современных современные
взаимодействие: взаимодействий
период: периоде
вымерший: вымершие
поддержание: поддержанию
выделить: выделил
участник: участникам
гибель: гибели
некоторые: некоторые некоторых
указывать: указывает
разделять: разделяло
обоняние: обоняния
сравнение: сравнении сравнению
внешний: внешнюю
данные: данных данные
расположенный: расположенные
олень: олень
переживать: переживают
сотня: сотни
ограниченный: ограниченный
собраны: собраны
микоризу: микоризу
век: веке веку
долина: долине долины
предпочитать: предпочитают
эндемичные: эндемичные
необычный: необычно
распространять: распространять распространяют распространяли
эволюционный: эволюционный эволюционных эволюционные
маклюра: маклюра
отложение: отложения
спороношения: спороношения
учитывая: учитывая
переносить: переносить
нескольких: нескольких
заключенными: заключенными
находиться: находился находятся
частичный: частично
чистый: чистой
получить: получить
говорить: говорят
приводить: приводит
кишечник: кишечник
ассоциация: ассоциаций
север: севере
окрашенные: окрашенные
ответить: ответить
мирсины: мирсины
африканский: африканского
зрение: зрения зрением
пищевой: пищевой
представитель: представителями представители
систематический: систематических
фрагмент: фрагменты
найдены: найдены
зависеть: зависят
институт: института
позволять: позволяет
хау: хау
восстановление: восстановлению
низина: низинами
совымирания: совымирания
распространенными: распространенными
распространяемые: распространяемые
неэндемичных: неэндемичных
выбран: выбран
праймеров: праймеров
материковый: материковых
найдена: найдена
моделирование: моделирование
вовсе: вовсе
проект: проекта
