углерод: углерода
промилле: промилле
микробная: микробная
время: временем
динамика: динамике динамику
отличие: отличие
окружающий: окружающую
непрерывность: непрерывности
человек: человека
век: века
месяц: месяца
полтора: полтора
ранее: ранее
целый: целое
большой: большой
связь: связи
перспективный: перспективных
понимать: понимать
хозяйство: хозяйствах хозяйстве
непропорционально: непропорционально
посев: посевы
шпицбергене: шпицбергене
вызванный: вызванная
какой: какое
экономика: экономике
выраженное: выраженное
линия: линия
мольной: мольной
морской: морском
широта: широты
прежде: прежде
который: которое которым котором
среда: среду
единый: единое
начаты: начаты
означать: означает
сайт: сайта
газ: газов газа газу газ газы
вклад: вклад вкладу вклада
сжигание: сжигание
помощь: помощью
мониторинг: мониторинга
существенно: существенно
тонна: тонн
вертикальный: вертикальная
рассматриваться: рассматривались
дно: дне
антропогенных: антропогенных
связывать: связывают
растущей: растущей
систематический: систематические
уровень: уровень
состояние: состояние
новый: новой нового новая новых
мишень: мишеней
атмосфера: атмосфере атмосферы атмосферу
проводить: проводят
альтернативный: альтернативные
азот: азота
озон: озон
сравнение: сравнении сравнению
считать: считают
выяснить: выяснить
увеличение: увеличения
высвобождаться: высвобождаться
число: числе
тропосферный: тропосферный
согласный: согласно
средний: средняя среднем средней средние средних
условие: условии
ним: ним
сохраняться: сохраняться
столетие: столетиями
пул: пул
биотоплива: биотоплива
болотный: болотные
бокс: бокс
глобальный: глобальных глобального глобальном глобальный глобальной глобальную
химический: химические
величина: величина величин величины
стоять: стоит
обратный: обратного
гидроксильного: гидроксильного
сосредоточиться: сосредоточились
недолговечный: недолговечен
отличаться: отличаются
характеризоваться: характеризуется
отдельный: отдельные отдельно отдельного
объемов: объемов
поступление: поступления
менять: меняли
микробной: микробной
почва: почве
темп: темп
оценивать: оценивают
исследование: исследований исследования
расти: росла
протокол: протоколы
согласоваться: согласуется
содержание: содержания
сгорание: сгорания
заметный: заметно
горизонтальный: горизонтальная
примерно: примерно
фторсодержащих: фторсодержащих
универсальный: универсальный
океанический: океанических
соотношение: соотношение
отметить: отметить
наблюдение: наблюдения наблюдениями
разбить: разбили
сложный: сложную
разрушаться: разрушается
разрешение: разрешение
перерыв: перерыва
модель: моделей модели модель
конкретный: конкретные
закись: закиси закись
понимание: понимания
группа: группы
лаборатория: лаборатории
институт: института
вопрос: вопрос
метангидраты: метангидраты
параллельный: параллельно
график: графики
лед: лед
животноводческий: животноводческих
зависимость: зависимости
разный: разной разными разные
вмерзший: вмерзший
начиная: начиная
воспроизвести: воспроизвести
сожаление: сожалению
экологический: экологических
заслуживать: заслуживает
ось: ось
парниковый: парниковых парниковый парниковые парникового
моделирование: моделирование моделирования
половина: половиной
показаны: показаны
анализ: анализа
изотоп: изотопов
наблюдаемые: наблюдаемые
определенной: определенной
относительный: относительного относительный
мировой: мировой
равный: равен равна
уравнение: уравнений
описывающие: описывающие
каждый: каждого каждом
детальный: детального
земля: земли
планета: планета
изотопный: изотопном изотопную изотопной изотопные изотопная
проблема: проблем
диапазон: диапазоне
зеландия: зеландия
сельский: сельском
рост: рост ростом роста росте
опубликованного: опубликованного
интервал: интервала интервал
различить: различить
метан: метана метане метан метаном
наблюдаемого: наблюдаемого
совпадение: совпадение
данные: данные данных данным
различный: различных различными
оказаться: оказалось оказались
обсуждаемой: обсуждаемой
предстоять: предстояло
описанный: описан
предусматривать: предусматривает
объяснять: объяснять
левый: левая
единица: единицу единице
определять: определяет
атмосферный: атмосферных атмосферная атмосферный атмосферного
измеряемых: измеряемых
использовать: использовали используют
данный: данный данном
углекислота: углекислоты
микроб: микробов микробами
прошедший: прошедшие
серпентинизации: серпентинизации
оказываться: оказывались
период: период периодов
полярный: полярных
быстрый: быстро
выделенный: выделенный
выполненными: выполненными
пандемия: пандемии
управление: управление
сбор: сбора
вносить: вносит
уменьшаться: уменьшалась
растет: растет
упорный: упорно
зеландии: зеландии
параметр: параметров
называть: называют
получение: получения
счет: счет
выделяться: выделяется
дальний: далее
рамка: рамках
температура: температура
замер: замеры
вступать: вступает
причем: причем
система: системы систему
тёплый: теплее
бюджет: бюджет
жизнь: жизни
растение: растений
независимый: независимо
промышленность: промышленности
миллиард: миллиард
предусматривающих: предусматривающих
годы: годы
снижение: снижение
показывать: показывает
измерение: измерений
некоторый: некоторую
топливо: топливо топлива топливом
указывать: указывает указывают
климат: климата климат
потенциал: потенциала
двигаться: движется
факторов: факторов
должный: должен
вызвать: вызвала
путь: пути
программа: программы
университет: университета
тренд: тренд
часть: частей
поэтому: поэтому
вырасти: выросла
сказаться: сказалась
состав: составе
механизм: механизма
откуда: откуда
реальность: реальности
потепление: потепления
еженедельно: еженедельно
ряд: ряды
заниженным: заниженным
изменение: изменения изменение изменению
попадать: попадает
оставаться: оставалась
временный: временных временное временные
промежуток: промежутки промежуток
образец: образца образцов
животное: животные
существенный: существенный
углекислый: углекислого углекислому углекислый
относить: относят
автор: авторы
внимание: внимания
отклонение: отклонение
оценка: оценки
предполагать: предполагают
продолжающиеся: продолжающиеся
метанотрофными: метанотрофными
точка: точки
фонового: фонового
возможный: возможно возможные
организация: организациями
рассмотрено: рассмотрено
нагрев: нагреве
вмешательство: вмешательства
способ: способы
соответствующий: соответствующие
преобразование: преобразование
напротив: напротив
сценарий: сценария сценариев
учесть: учли
сток: стоки сток стоков стока
фторсодержащие: фторсодержащие
продукт: продукт
случай: случае
межправительственный: межправительственной
цельсий: цельсия
равняться: равнялось
окисление: окисление
раз: раза
канада: канада
рассмотренный: рассмотренный
разниться: разнится
изменять: изменять
михаил: михаил
журнал: журнале
выполненных: выполненных
работа: работами работе
связано: связано
порода: пород
эксперт: экспертов
образующегося: образующегося
уменьшение: уменьшение
фон: фоне
отчасти: отчасти
синус: синус
собранный: собранные
поток: потоков потока
рисунок: рисунок
доклад: докладу
национальный: национальное национального
радикал: радикала
угодье: угодья
исключение: исключением
стандартный: стандартного
низкий: низкими
горючий: горючих горючими
активность: активность
рассчитать: рассчитали
основа: основе
остается: остается
накопление: накопление накоплением
значение: значения значениями значение значений
горный: горных
использование: использования использованием
резкий: резко резкого
необходимый: необходимо
первостепенный: первостепенное
тохоку: тохоку
соответствовать: соответствуют
эмиссия: эмиссии эмиссия
миллион: миллион миллиона
водный: водных водно
сжигаемой: сжигаемой
норвегия: норвегия
множество: множество
процесс: процесса процесс
пирогенного: пирогенного
уголь: уголь угля
среди: среди
доля: доли
микроорганизм: микроорганизмы микроорганизмами
обработка: обработки
позволять: позволяет
болото: болота болотах
антропогенной: антропогенной
природа: природы
градус: градусы градуса
сильный: сильно
удельный: удельному удельная
иметь: имеет
максимальный: максимальный максимально максимального максимальным
макса: макса
источник: источников источникам источник источники источника
реакция: реакции
наложенные: наложенные
описать: описать
исходный: исходное
некоторые: некоторых некоторые
активный: активнее активной
подпись: подпись подписи
нефть: нефть
сила: силами
связанный: связанных связанная связанный связанной
представлять: представляет
экосистема: экосистемах
германий: германии германия
антарктиде: антарктиде
ведущий: ведущего
площадка: площадки
например: например
эффект: эффект
ученые: ученые
стать: стала стать
стабильный: стабильной стабильных
сша: сша
воздух: воздух
масштаб: масштабе
выведение: выведения
серый: серая
орёл: орлов
моль: молях
скорость: скорости скоростью
объема: объема
свалка: свалках свалки
цвет: цветами
концентрация: концентрации концентрация
неделя: недели
получены: получены
годов: годов
минимальный: минимально
деятельность: деятельность деятельностью
позволить: позволило
природный: природных природный
планка: планка
сельскохозяйственный: сельскохозяйственные
количество: количества
алерте: алерте
постоянный: постоянно постоянной
приток: приток
биомасса: биомассы
годах: годах
живущий: живущих
предмет: предметом
высокий: выше
уступать: уступает
составить: составила
климатологов: климатологов
усиливающих: усиливающих
рекордный: рекордного
установить: установить
выброс: выбросы
центр: центре
точнее: точнее
япония: японии
варьировать: варьирует варьировали
получать: получают
оптимальный: оптимально
реальный: реальную
характеризовать: характеризуют
объяснить: объяснить
результат: результат
повышение: повышения
правый: правая
рис: рис
статья: статьи
скотоводство: скотоводство
влияние: влиянием
десятилетие: десятилетия
ископаемое: ископаемое ископаемых ископаемого ископаемым ископаемыми
вещество: вещества
шел: шел
фиолетовый: фиолетовая
близкий: ближе
соединение: соединения соединений
оценить: оценили
тропосфере: тропосфере
