обратно: обратно
работа: работе работу
конструкты: конструкты
стать: стали
клетка: клетки клеток клетка клетку клетке
понять: понять
давать: дают
окружение: окружении
сайт: сайта
перестройка: перестройка перестроек
частность: частности
свой: своим своему
образование: образование
укрупнение: укрупнение
каждый: каждом
средний: среднем
приобретение: приобретением
переходить: переходить
показано: показано
тяжелые: тяжелые
умножиться: умножились
хромосомной: хромосомной
позволить: позволить позволило
практиковать: практикуют
схема: схема
диплоидному: диплоидному
клеточный: клеточных клеточного
частота: частота
копия: копии копий копиями копия
полиплоидии: полиплоидии
исключительный: исключительно
дуплицированными: дуплицированными
контролируемой: контролируемой
функция: функции
фаза: фазам
данные: данных
дно: дна дне
червь: червей
этап: этапах этапе
отбор: отбор отборе отбора
указывать: указывает
освещать: освещали
карповый: карпов
сосредоточиться: сосредоточились
поддержание: поддержанию поддержание
одну: одну
трофических: трофических
днк: днк
подсчет: подсчет
наводить: наводит
стабилизировать: стабилизировать
сюжет: сюжет
квадрат: квадрат
рыхлый: рыхлой
длина: длину
тысяча: тысячи
поддерживать: поддерживать
иметь: имеет имеют
полиплоидов: полиплоидов
мочь: могли
механизм: механизмы механизмом механизм
опубликованные: опубликованные
наймарк: наймарк
измениться: изменилась изменились
американский: американские американских
широкий: широкое
тенденция: тенденцию
адаптационное: адаптационное
начальный: начальных
макроскопический: макроскопические
конечный: конечный
модель: модель
прояснить: прояснить
геном: генома
организм: организм организма организмы
укрупнились: укрупнились
вопрос: вопрос
требование: требования
увеличивая: увеличивая
пересчете: пересчете
вдвое: вдвое
факт: факте
отладка: отладка
увеличение: увеличении увеличения
оказываться: оказываются
пробирка: пробирки пробирке
объеме: объеме
лежалый: лежала
генетический: генетическое генетическом
главный: главный
возникшая: возникшая
поддержка: поддержке
удлинились: удлинились
привел: привел
многообещающий: многообещающий
папоротник: папоротников
левый: левый
отбирающая: отбирающая
крупный: крупных крупные
известный: известна известно
фенотипических: фенотипических
увеличиваться: увеличивается
удвоенный: удвоенного удвоенным
мутация: мутации
взят: взят
упаковка: упаковки упаковок
выснили: выснили
прижиться: прижиться
дупликация: дупликация
эффективный: эффективным эффективный
адаптивную: адаптивную
автор: авторы
выявить: выявил
превосходный: превосходно
удвоение: удвоение
прародительница: прародительницы
параметр: параметры
специалист: специалисты
сравнение: сравнения
размер: размер размера размеру размеры размеров
среди: среди
размножение: размножения
конкурент: конкурентов
исчезать: исчезает
полногеномные: полногеномные
помочь: помог
организовать: организовали
история: истории
уровень: уровень
тетраплоидных: тетраплоидных
трансформация: трансформаций
неустойчивый: неустойчивы
работать: работали
геномных: геномных
проверить: проверили
жалить: жаль
растение: растения растений
питание: питания
серия: серии
снежинка: снежинки снежинок
происходить: происходит происходили
животное: животные
экспериментатор: экспериментаторов
условие: условиях условиям
выдерживать: выдерживают
крайний: крайней
приводить: приводит
течение: течение
выигрывать: выигрывают
насчитываться: насчитывается
форма: форме формы форма форму
немедленный: немедленное
ограничение: ограничения ограничение
важный: важно важны
небольшой: небольшая
настройка: настройка
снять: сняли
предок: предков
аллелей: аллелей
сфокусировались: сфокусировались
реперных: реперных
метаболизма: метаболизма
благодаря: благодаря
рассказав: рассказав
многоклеточный: многоклеточными многоклеточных многоклеточные многоклеточного
джорджии: джорджии
долгий: долгого
сконструировать: сконструировали
модельный: модельный
отлаженной: отлаженной
костистый: костистых
основа: основе
состояние: состоянию
объемов: объемов
срез: срезов
выглядеть: выглядит
причем: причем
дупликаций: дупликаций
полиплоиды: полиплоиды
комочек: комочки
сформировав: сформировав
адаптивное: адаптивное
эксперимент: эксперимент эксперимента эксперименте
повышать: повышает
процесс: процесс
нестабильность: нестабильность
институт: института
свобода: свободу
действие: действия
носитель: носителям
сформировались: сформировались
длинный: длинные
чрезвычайный: чрезвычайно
разбирать: разбирает
любой: любого
дальний: далее
одиночный: одиночным
напоминающие: напоминающие
фото: фото
ученые: ученые
формирование: формировании формирования
претерпеть: претерпели
кластер: кластеры кластеров кластера
реконструкция: реконструкция
деление: деления
целить: цель
ежедневно: ежедневно
разный: разной
весьма: весьма
открытый: открытым
соответственный: соответственно
изучить: изучить изучили
выигрыш: выигрыш
хромосомного: хромосомного
ген: генах гены
повторности: повторности
жесткая: жесткая
адаптация: адаптация адаптацию
раздуться: раздулись
задача: задаче
необходимый: необходимые
поровну: поровну
эволюция: эволюции эволюция
размножаться: размножаются
анаэробных: анаэробных
распространение: распространение
наоборот: наоборот
анаэробные: анаэробные
такой: таким таком
обеспечить: обеспечила
номер: номера
организация: организации
какой: какую
лишний: лишней лишнего лишняя
род: рода
возможность: возможность
опережать: опережали
обеих: обеих
неизбежный: неизбежно
метаболизму: метаболизму
начало: начале
общий: общее
умноженными: умноженными
срабатывать: срабатывает
смешать: смешать
источник: источник
целый: целые
популяция: популяций популяции
очевидный: очевидные очевидно
полногеномных: полногеномных
устойчивый: устойчивые
конкретный: конкретных конкретной
раз: разом
быстрый: быстрая быстро
часть: часть
дневной: дневного
повторностях: повторностях
эффект: эффект
пик: пика
многоклеточности: многоклеточности
становление: становлении
конец: концом конце
полногеномная: полногеномная
продолжиться: продолжился
диплоидных: диплоидных
моментальный: моментальный
слово: словами
лаборатория: лабораторий
получиться: получился
затратность: затратность
плоский: плоских
подчеркивают: подчеркивают
решение: решение
доказанный: доказано
присутствовать: присутствуют
вклад: вклад
помощь: помощью
лососевых: лососевых
превратиться: превратились
больший: большую
являться: является
среда: среды средой
объесть: объем
диплоидов: диплоидов
герой: герой
тип: типов типа тип
самый: самые самый
дочерний: дочерние дочерних
воспользоваться: воспользовались
следующий: следующем
укрупниться: укрупниться
комплект: комплекта
дополнительный: дополнительный дополнительные дополнительном
иной: иными
жидкий: жидкой
статья: статьи
пять: пяти
количественный: количественный
поколение: поколений
сторона: сторону
меря: мере
экспериментальный: экспериментально
вырасти: вырос выросли вырасти
журнал: журнале
конструктов: конструктов
отсаживаться: отсаживались
логичный: логичной
масштабный: масштабным
диплоидной: диплоидной
появление: появления появлению
долговременный: долговременного
доказывать: доказывали
сила: сила силы
мысль: мысль
полиплоидность: полиплоидность
применив: применив
образ: образом
разобраться: разобраться
частить: части
ведется: ведется
дупликации: дупликации
первичный: первичной
положение: положение
поэтому: поэтому
заметный: заметно
графике: графике
помимо: помимо
дает: дает
сохраняться: сохраняться сохраняется
стресс: стрессов
сохранять: сохранять
технологический: технологического
эксплуатировать: эксплуатировала
линия: линиях линии линий
некоторые: некоторые некоторых
возвращаться: возвращаются
проясняться: проясняются
дрожжи: дрожжи дрожжах дрожжами дрожжей
роль: роль
путь: путь
ход: ходе
вытянуться: вытянулись
тетраплоидные: тетраплоидные
диаметр: диаметр
количество: количества количество
играть: играет
геномной: геномной
рыба: рыб
исходный: исходные исходной исходных
стабилизация: стабилизация стабилизации
выживание: выживания
увеличиться: увеличились увеличилось
приносить: приносит
новый: нового новые новая новым новом
жесткие: жесткие
отдельный: отдельного отдельных отдельным отдельными
одноклеточный: одноклеточных
идея: идею
публикация: публикация
центральный: центральные центральной
день: дней дня
число: числа числом число
сравнить: сравнили
пекарский: пекарские
увеличить: увеличить
круглый: круглых
повторностей: повторностей
адаптационный: адаптационный
ряд: ряда ряду
результат: результате результаты результат
активный: активному
исследование: исследование
сохранить: сохранили
преимущество: преимущество преимущества
сделав: сделав
польза: пользу
изменение: изменение изменений
ракурс: ракурсе
сконструированные: сконструированные
нестабильный: нестабильна нестабильного
елена: елена
характерный: характерна
проявиться: проявился
тонкий: тонких
расхождение: расхождением
приобрести: приобрели
диплоидные: диплоидные
рисунок: рисунок
сильный: сильнее сильно
орган: органа
позвоночный: позвоночных
безусловный: безусловную
устойчивость: устойчивости
наращивать: наращивать
вещество: вещества
несбалансированность: несбалансированность
деталь: детали
произойти: произойти
набор: набора набор
повышение: повышение
потомок: потомками
столь: столь
первый: первые
скапливаться: скапливались
дальнейший: дальнейшего
разрастание: разрастание
соответствовать: соответствуют
колония: колонии колоний колониях
например: например
анаэробного: анаэробного
отлаживать: отлаживать
отпочковывая: отпочковывая
велся: велся
трофического: трофического
вид: видов
ожидаемым: ожидаемым
вытеснить: вытеснить
объект: объект
ансамбль: ансамблей ансамбля
несмотря: несмотря
обсуждаемой: обсуждаемой
предшественница: предшественницы
получать: получать получает
хромосома: хромосом хромосомы хромосомах хромосомами
существенно: существенно
плотность: плотность
элемент: элементы
показаны: показаны
снялось: снялось
извне: извне
эволюционный: эволюционной эволюционных эволюционном эволюционные
диплоидами: диплоидами
скопление: скоплений скопления
эукариот: эукариот
трех: трех
идущего: идущего
обычный: обычные обычными
многие: многие
полногеномной: полногеномной
аэробный: аэробного
нужда: нужды
потеря: потери
современный: современных
тетраплоиды: тетраплоиды
большой: большого
смочь: смогли
оказаться: оказались
вновь: вновь
выясниться: выяснилось
геномная: геномная
эфективно: эфективно
отбирались: отбирались
смешанный: смешанного смешанных
строгий: строго
видимый: видимому
сходный: сходными
помогать: помогает
яркий: яркие
новость: новости
совместный: совместного
резкий: резко
вполне: вполне
конкуренция: конкуренцию
противоречие: противоречием
