монофенестратам: монофенестратам
родственник: родственниках родственников
летун: летунами летуны летун
функция: функцию
полета: полета
внимание: внимание
кость: кость
новиковская: новиковская
скелет: скелета
древнейший: древнейшей
миниатюрный: миниатюрных
сравнение: сравнения сравнение
возможный: возможно
странствующего: странствующего
марабу: марабу
доказательство: доказательством
длиннохвостые: длиннохвостые
облегчить: облегчить
древний: древней древний
однооконным: однооконным
птерозавра: птерозавра
глазница: глазницей глазница
некрупный: некрупными
конец: конец конце
рассеченный: рассеченный
отметить: отметить
энергичный: энергичному
сильный: сильным
контрплиты: контрплиты
сохраниться: сохранились
находка: находке находка находок
птеродактилоидов: птеродактилоидов
хацегоптериксу: хацегоптериксу
получить: получил
ящер: ящеров ящеры ящерам
черепной: черепная
видовой: видовой
изолированный: изолированного
минимум: минимум
маневренность: маневренность
занимающим: занимающим
колышкообразными: колышкообразными
пар: пара
костя: кости костей
мелкамтера: мелкамтера
поворотливый: поворотлива
корм: корм
рисунок: рисунок
называть: называют
удивительный: удивительно
равнина: равнинам равниной
предчелюстная: предчелюстная
самый: самых самый
добывать: добывать
длинный: длинными длиннее длинным
находить: находили находят
зуб: зубов зуба зуб зубами зубы
рамфоринхи: рамфоринхи
триасе: триасе
полушарие: полушария полушарии
слева: слева
пепел: пеплом
крючок: крючком
занять: занял
черта: черт
реконструкция: реконструкция
позволять: позволяют
обсуждаемой: обсуждаемой
например: например
сантиметр: сантиметров
птеродактиль: птеродактиля
летяг: летяг
произойти: произошли
сайт: сайта
аргентинский: аргентинском
отдельный: отдельными
внешний: внешний
четвероногий: четвероногих
развиваться: развивались
длина: длина длины
храниться: хранится
внутриконтинентальной: внутриконтинентальной
сохранившихся: сохранившихся
тафономические: тафономические
исследователь: исследователей
альвеола: альвеолы альвеол
обозначен: обозначен
согласный: согласно
морфология: морфологии
возраст: возраст
музей: музее
приходиться: приходятся
отверстие: отверстие
привести: привело
типичный: типичный
уживаться: уживаются
асфальто: асфальто
волатикотерия: волатикотерия
повысить: повысило
организм: организме
любопытнее: любопытнее
рыба: рыбу рыб
чешуйчатый: чешуйчатая
рыбоядным: рыбоядным
сливаться: сливаются
летающие: летающие
царствовать: царствовали
клюв: клюв
изучался: изучался
очередь: очередь
легкие: легкие
челюсть: челюсть
принадлежность: принадлежность
вопрос: вопросом
отложение: отложениях
крылатый: крылатых крылатые крылатая
итог: итоге
озер: озер
богатый: богатой
монофенестаты: монофенестаты
поверхность: поверхности
достигнуть: достигла
вытеснять: вытеснять
контрпластина: контрпластина
эджидио: эджидио
различимый: различимым
моллюск: моллюсков
птерозавр: птерозавр
трехметровая: трехметровая
трель: трелью
доисторический: доисторическим
жизнь: жизнью
юрскому: юрскому
подробность: подробностях
отнести: отнести
обратить: обратите
нелетающего: нелетающего
когтистый: когтистые
размер: размеров
помимо: помимо
возникнуть: возникла
связанный: связанных
млекопитающий: млекопитающих
выполнявшими: выполнявшими
используемый: используемые
служить: служить
невелик: невелик
отличаться: отличается
вместе: вместе
падаль: падалью
признак: признаки
блок: блок
сохранившийся: сохранившийся
ближайший: ближайших
пястной: пястной
мелкамтер: мелкамтер
судить: судить
день: дня дней
существовать: существуют
воздух: воздухе
юрских: юрских
происходить: происходят
изображение: изображениями
динозавр: динозавров
фотография: фотография
высокий: высоким
добыча: добыча
маневренному: маневренному
анатомия: анатомии
слово: слова
сокращение: сокращения
точный: точно
крупный: крупным крупного крупных
лапа: лапы
нотариум: нотариум
разделенные: разделенные
стоять: стоит
больший: большие большая
относительный: относительно
позвонок: позвонки позвонков
голова: головами головы голова голову
всемирный: всемирного
гибель: гибели
пример: примере пример
гипотеза: гипотез
первый: первые
повлиять: повлиять
рептилия: рептилии
стабилизатор: стабилизаторов стабилизатора стабилизатором
восходящий: восходящий
ящерица: ящерица
освоившие: освоившие
похожий: похожих
ход: ходе
масштабный: масштабного
представить: представить
особенность: особенностью
летающих: летающих
дело: деле
сделанная: сделанная
ранний: ранние раннему ранних раннего ранний раннем
мочь: могли могло
рамфоринхоидами: рамфоринхоидами
юрском: юрском
впервые: впервые
изобилующий: изобилующий
сам: самое
дерево: деревьями
шотландия: шотландии
объяснять: объясняет
обнаружить: обнаружили
эпитет: эпитет
множество: множеством
обладать: обладал обладали
одно: одно
палеонтологический: палеонтологическом палеонтологической
носовой: носовой
вероятный: вероятно
наземный: наземных наземными
окаменелость: окаменелости
успешный: успешной успешно
оценивается: оценивается
рамфоринха: рамфоринха
дарвиноптер: дарвиноптер
сохранившегося: сохранившегося
распространение: распространения
ключевой: ключевой ключевое
роль: роль
пищать: пищу
слезная: слезная
напоминать: напоминал
летопись: летописи
элемент: элементы
птеродактилоида: птеродактилоида
полученными: полученными
близкий: близких
включать: включает
редкий: редко
четырех: четырех
костный: костных
линия: линии
взять: взял
втрое: втрое
предыдущий: предыдущего
аргентоконодон: аргентоконодон
найдены: найдены
двести: двухсот
помочь: помогло
грудной: грудных
расположенный: расположены
голотип: голотип
морской: морской морских
прибрежный: прибрежной прибрежных
рис: рис
континент: континентах
носоглазничное: носоглазничное
мирный: мирно
ловля: ловле
точнее: точнее
птеродактилоидам: птеродактилоидам
пожар: пожарам
дарвиноптера: дарвиноптера
обнаружение: обнаружения
жесткими: жесткими
сращенные: сращенные
конструкция: конструкции
рудиментарный: рудиментарный
найден: найден
отрезка: отрезка
сохранение: сохранение
наподобие: наподобие
прогрессивный: прогрессивные прогрессивной прогрессивным
череп: черепом черепа черепами череп черепе черепах
предглазничное: предглазничное
юрского: юрского
заглазничное: заглазничное
позволяющей: позволяющей
одном: одном
состоять: состоит
прорисовка: прорисовка
периодически: периодически
неуклонный: неуклонно
большой: большое
подвисочное: подвисочное
укорочение: укорочение
обширный: обширной
летать: летать
собирать: собирал
отличие: отличие
благодаря: благодаря
позвоночный: позвоночные позвоночных
головоногие: головоногих
животное: животных животными животным
массовый: массовой
составлять: составляет
общий: общей
приводить: приводило
германий: германии
сообщить: сообщила
означать: означает
ферульо: ферульо
основный: основной
мозаичный: мозаичной
частичный: частичного
известный: известных
катастрофа: катастрофам
машущий: машущий
южноаргентинской: южноаргентинской
филогенетического: филогенетического
рекордсмен: рекордсмена
вырост: вырост
амфибий: амфибий
летучий: летучим
каньядон: каньядон
след: следы
умелый: умелыми
птица: птиц
примитивный: примитивного примитивные
река: рек
редкость: редкость
представитель: представителя представителям представитель представители
форма: формы форм форме
юг: юге
окно: окно окна окном
альбатрос: альбатроса
крайний: крайне
эволюция: эволюции
крепкий: крепкие
легким: легким
картинка: картинку
питание: питания
плита: плиты
обнаруженного: обнаруженного
вполне: вполне
накрывать: накрывало
начать: начали
укороченным: укороченным
огромный: огромными
уникальный: уникальных
конечный: конечном
появление: появлению
индеец: индейцев
полоть: полет
нижний: нижняя нижней
верхний: верхняя
старый: старше
клад: клада
биоты: биоты
фрагмент: фрагменты фрагментов фрагмента
меловому: меловому
квадратноскуловая: квадратноскуловая
отсутствовать: отсутствует
анна: анна
течение: течение
небо: небесах
примерно: примерно
область: области
чудовище: чудовища
предположение: предположения
скуловой: скуловая
проворный: проворных
земля: земле
период: периоду периоде периода
остаток: остаткам остатков
рамфоринхоида: рамфоринхоида
помощь: помощью
триасовом: триасовом
скорый: скорее
короткий: короткими короткие
сравнительный: сравнительно
планировавшего: планировавшего
край: край
насекомоядный: насекомоядным насекомоядный
полету: полету
переход: перехода переход
мезозойский: мезозойских
уцелеть: уцелели
ним: ним
птеродактилоидами: птеродактилоидами
небольшой: небольшими
южный: южном
формация: формации
язык: языка
присутствовать: присутствует
ноздревое: ноздревое
образуя: образуя
современный: современному современных
набор: набор
носоглазничным: носоглазничным
клювоголовых: клювоголовых
вулканический: вулканическим
уменьшиться: уменьшились
заметный: заметно
рамфоринхоидов: рамфоринхоидов
позднемелового: позднемелового
отросток: отросток
вид: вида вид
строение: строения
чудовищный: чудовищно
квадратный: квадратная
затруднено: затруднено
кесо: кесо
живший: живший
родич: родича
хацегоптерикса: хацегоптерикса
помогать: помогать
насекомое: насекомые
класс: класса
лопатка: лопаток
наших: наших
однооконную: однооконную
название: название
лунка: лунки
статья: статьи
носоглазничного: носоглазничного
сразу: сразу
птерозавры: птерозавры
хвост: хвостом хвостами хвосты хвоста
томографии: томографии
предок: предков
птерозаврам: птерозаврам
китайский: китайский китайского
местность: местность
ралладо: ралладо
ученые: ученые
прогуливаясь: прогуливаясь
компьютерный: компьютерной
сестринский: сестринской
судя: судя
группа: группа группой
среда: среде
поздний: позднем позднему поздних
аргентина: аргентины
предположительно: предположительно
выглядеть: выглядят
шейный: шейных
новый: нового новая новый
северный: северного
спинной: спинные
родовой: родовое
источник: источник
неопределенных: неопределенных
охотиться: охотились
знание: знания
появиться: появились
долгий: долгое
переходный: переходных переходная
птерозавров: птерозавров
результат: результатам
факторы: факторы
геологический: геологической
маневрировать: маневрировать
африканский: африканскому
сочетавший: сочетавший
перевести: перевести
метр: метр
трансильвании: трансильвании
нескольких: нескольких
добавлена: добавлена
монофенестрат: монофенестрат
теуэльче: теуэльче
анализ: анализа
совершенствоваться: совершенствовался
нужный: нужна
такой: таких
плохой: плохо
коробок: коробка
пора: порой
адаптация: адаптацией
стрекоза: стрекоз
поденок: поденок
крокодилов: крокодилов
