оставаться: оставались
редкий: редко
трение: трение
европа: европы
дно: дна дном дно дне
мпс: мпс
достаточный: достаточно
фотография: фотография
клетка: клетками клеток
срез: срез
донный: донных
случай: случае
предположить: предположить
верхний: верхней
роговой: роговой
щиток: щитками
подчеркивает: подчеркивает
больший: большую большая
плавание: плавании плавание
который: которое которым котором
карьера: карьере
крепиться: крепиться
мышца: мышцы
светлый: светлой светлым
сближающая: сближающая
рептилия: рептилий рептилии
обтекаемость: обтекаемость
генри: генри
пар: пару
обнаружение: обнаружения
несмотря: несмотря
община: общины
моллюск: моллюсков
найденных: найденных
помощь: помощью
базальный: базальный
видимый: видимых
питаться: питалась
место: местом места место
проходящем: проходящем
кератиноцитов: кератиноцитов
отличаться: отличаются
сайт: сайта
вносить: вносила
дуга: дуги
контур: контур
богатый: богаты
фрагмент: фрагмента
противоречить: противоречит
минимум: минимум
ллуйд: ллуйд
вклад: вклад
мэри: мэри
изучить: изучить
удостоиться: удостоилась
живот: живота
вставка: вставкой
обыкновенный: обыкновенной
выясниться: выяснилось
дракон: драконов
представление: представления
стрелок: стрелками стрелки
электронный: электронную
рогового: рогового
гладкий: гладкая гладкие гладкой
семиметровой: семиметровой
примечательный: примечательная
ряд: ряды
меланосомных: меланосомных
плававшему: плававшему
столетие: столетий
цвет: цветом
полученная: полученная
биология: биологии
палеонтолог: палеонтологов палеонтологе палеонтологи палеонтолог
метода: методы
толщина: толщина
описанный: описаны описанные описана
повреждение: повреждений
крыло: крылья
вспахивая: вспахивая
зафиксировать: зафиксировать
деминерализованной: деминерализованной
эпидермальными: эпидермальными
найти: найти
чешуйчатый: чешуйчатыми чешуйчатый
составлять: составляют
продольный: продольного
стьюкли: стьюкли
яйцо: яйца
спектроскопия: спектроскопию
плезиозавр: плезиозавру плезиозавры плезиозавра плезиозавров плезиозавр
свой: свой
мускулатура: мускулатура
посередине: посередине
панциря: панциря
покров: покровах покровами покровы покров
откладывать: откладывать
мкм: мкм
чешуей: чешуей
бескислородных: бескислородных
повезти: повезло
брюхо: брюхо
конечность: конечности
серый: серым
ион: ионов
эпидермис: эпидермиса эпидермис
крупный: крупных
киль: киля
век: веке века
ихтиозавр: ихтиозавры ихтиозавров
поначалу: поначалу
итог: итоге
мозаика: мозаикой
сохраняться: сохраняется сохраняются сохраняться
группа: группу
спина: спине
обратить: обратите
шиповатого: шиповатого
покрывало: покрывала
кожа: кожа кожи кожу
форма: форму форма
соединение: соединения
белая: белыми белые
морской: морские морских морского морским
швеция: швеции
статья: статью статья статьи
микроспектроскопию: микроспектроскопию
контакт: контакте
схожий: схожие
диагенез: диагенез
позволять: позволяло
понять: понять
вид: виде вида вид
известный: известных известно известны
позвонок: позвонки позвонков
рентгеновский: рентгеновскую
визуализированная: визуализированная
покрывавших: покрывавших
плотный: плотная
латинизированного: латинизированного
хольцмаден: хольцмаден
остистый: остистые
внимание: внимания внимание
показывающая: показывающая
возможный: возможно
коллега: коллега
черные: черные
микротелец: микротелец
усиливать: усиливали
шея: шеи шее шею шеями
небольшой: небольшие
учитывая: учитывая
меланосомные: меланосомные
исключено: исключено
протяжение: протяжении
хвост: хвосте хвост хвоста
исландии: исландии
отношение: отношении
четырехкрылого: четырехкрылого
команда: команда
меланосом: меланосом
смочь: смогли
структура: структура структур структуры
тело: тела тело
толстый: толстый толстым
вспугивая: вспугивая
сверху: сверху
мягкий: мягких мягкие
принять: принял
позднемелового: позднемелового
раздробленный: раздробленным
окаменелость: окаменелости
указаны: указаны
демонстрировать: демонстрирует
например: например
образ: образом
фоссилизации: фоссилизации
панцирь: панцирь
эдвард: эдвард
прямоугольник: прямоугольником
положение: положение
гадюка: гадюки
кольцо: кольца
удалось: удалось
ранний: раннему
микротельца: микротельца
принадлежать: принадлежали принадлежит
мочь: могли
суша: сушу
использование: использованием
сохранившемуся: сохранившемуся
вещество: вещества
интерпретировать: интерпретировали
полученное: полученное
анна: анна
доисторический: доисторические
установить: установить установили
исчезнуть: исчезла
появление: появлению
порода: породы
ученых: ученых
включая: включая
отпечаток: отпечатки
сканирующую: сканирующую
жесткость: жесткость
английский: английский
геолог: геолог
ядро: ядрами
удаление: удалением
отмечающей: отмечающей
ласты: ласте ласты ласта ласт ластах
загадка: загадкой
хокинса: хокинса
прижизненный: прижизненный
ценный: ценных
частичный: частично
одни: одни
поэтому: поэтому
разнообразный: разнообразными
спектрометрия: спектрометрию
мозазавров: мозазавров
знать: знаем
рисунок: рисунок
напоминать: напоминали напоминал напоминают
доступный: доступные
слоистость: слоистость
дворец: дворца
подобный: подобно подобные
остаться: остались
область: областями область областью
пронизанной: пронизанной
вторичный: вторичных
триаса: триаса
змея: змей змею
волокно: волокнами
напротив: напротив
продолговатый: продолговатых
условие: условиями
раннеюрских: раннеюрских
некоторые: некоторым некоторых
валлийский: валлийский
насчитываться: насчитывалось
латынь: латыни
точка: точками точки
многие: многого многие многих
показывающее: показывающее
ящерица: ящериц
лебединый: лебединые
беспомощный: беспомощных
череп: черепом черепах
образец: образец образцов
найденный: найденный
предположительно: предположительно
питание: питания
красный: красным
обладающих: обладающих
линяющий: линяющий
артефакты: артефакты
сквозь: сквозь
найдены: найдены
тафономическими: тафономическими
нынешний: нынешней нынешних
обеспечивать: обеспечивали
альбертонектеса: альбертонектеса
изобразить: изобразил
привести: привела
большой: большое большого
живородящий: живородящий
кожистый: кожистой
внешний: внешнем внешних внешне внешнего внешний
настоящий: настоящих
иллюстрация: иллюстрации
инфракрасный: инфракрасную
вертикальный: вертикальные
задний: заднего заднем
полученной: полученной
динозавр: динозавров
описывать: описывали
видный: видны видна видно
поверхность: поверхности поверхность
сочетаться: сочеталась
долгий: долгое
картинка: картинку
осадком: осадком
самый: самый
собственный: собственное
длинношеего: длинношеего
полноценный: полноценно
распределение: распределению
крокодил: крокодила
полный: полных полный
электрон: электронов
скопление: скопления
эумеланина: эумеланина
ископаемый: ископаемой
выполнение: выполнения
ящер: ящеры ящера ящеров ящер
пошлый: пошло
немалый: немалый
древний: древний
сожаление: сожалению
миллион: миллиона
никак: никак
широкий: широкие шире
микроскопия: микроскопию
современный: современной современных
шиповатый: шиповатый
работа: работе
меняться: менялись
позволить: позволило
чешуйка: чешуйки чешуек
служивший: служивший
ищущий: ищущих
правый: правой правого
сохранившимся: сохранившимся
маурициозавра: маурициозавра
сланец: сланцах сланцы
древние: древних
передний: переднем переднего передней
пролезшую: пролезшую
сэм: сэм
шиповатом: шиповатом
частность: частности
заметный: заметно
иметься: имелся
кератиноциты: кератиноциты
благодаря: благодаря
мель: мел
скелет: скелет скелеты скелета скелетом
сегодняшний: сегодняшний
пау: пау
различимый: различимы
чей: чьи
различие: различия
эннинг: эннинг
молодой: молодого
доэ: доэ
изображение: изображение
выглядеть: выглядели
международный: международному
темными: темными
сторона: стороны
допотопный: допотопные
затаившуюся: затаившуюся
характерный: характерных
ископаемое: ископаемом
снижая: снижая
часть: часть частях
животное: животные животных животного животному
боков: боков
исследовать: исследовала
сказка: сказка
отросток: отростки
заполнение: заполнение
правда: правда
остаток: остатки остатков остатках
редкость: редкость
след: следы
площадь: площадь
становящихся: становящихся
килеватой: килеватой
знаменитый: знаменитой
гибкий: гибкими
коллагеновыми: коллагеновыми
отложение: отложения отложениях
вероятный: вероятно
меланофоры: меланофоры
отличие: отличие
субтреугольные: субтреугольные
океан: океанах
округлый: округлые
называть: называют
выползать: выползать
извлечение: извлечении
ученые: ученые
стремиться: стремились
количество: количество количества
ограничивать: ограничивали
функция: функций
германий: германии
увеличена: увеличена
подробный: подробно
свет: свете
ткань: тканей
хороший: хорошую
такой: таким
пищать: пищу
нижний: нижней
исключительность: исключительность
предок: предков
лучшее: лучшем
беш: беш
жившего: жившего
подготовка: подготовке
трех: трех
новый: нового
ранее: ранее
возвращение: возвращение
средний: средней
взятие: взятия
эллипсоидальные: эллипсоидальные
песок: песка
источник: источник
огромный: огромных
день: дня
счет: счет
крохотный: крохотных
сходство: сходство
новиковская: новиковская
существовать: существовали
шкура: шкуры шкура
змеиный: змеиные змеиными
способность: способность
голотип: голотип
субтреугольная: субтреугольная
похожий: похожей
мезозойский: мезозойской
близкий: ближе
обнаруженные: обнаруженные
находка: находки находка
толстокожесть: толстокожесть
охота: охота
черепаха: черепахам черепахи черепахой
черной: черной
предположение: предположению предположениям
корнеоцитов: корнеоцитов
фоссилии: фоссилии
неопределенного: неопределенного
посткраниальным: посткраниальным
мексика: мексики
край: края крае
получить: получили
пустота: пустоты
покрытый: покрыт покрыто
облегчать: облегчала
подчеркнуть: подчеркнуть
пристальный: пристального
судя: судя
число: числе
утратить: утратили
жизнь: жизни
выделенный: выделены выделена
изучив: изучив
дифракция: дифракцию
сохраниться: сохранился сохранились сохранилась
диагенетически: диагенетически
желудок: желудке
море: морях
миро: миру
птица: птиц
отраженных: отраженных
любитель: любителе
отсутствие: отсутствию отсутствие
подводный: подводные
древнегреческий: древнегреческого
представлять: представляли
посидония: посидония
окружающий: окружающей
длинный: длинные
изгибать: изгибать
головоногие: головоногих
сложный: сложными
внутренний: внутреннюю
британский: британский
мускулистый: мускулистым
мсви: мсви
слой: слой слои слоя слое слоях
обитый: обитая
прорисовка: прорисовка
икм: икм
линия: линии
эффективный: эффективно
коллектив: коллективу
аспект: аспекты
предроговой: предроговой
непреднамеренный: непреднамеренным
отдельный: отдельную
пингвин: пингвина
коричневый: коричневым
преобразован: преобразован
эра: эры
великолепный: великолепно
складка: складки
разрыв: разрыва
энергодисперсионную: энергодисперсионную
обсуждаемой: обсуждаемой
диаметр: диаметре
добыча: добычу
уильям: уильям
пересмотрены: пересмотрены
запас: запасов
скорый: скорее
тёмный: темно
чешуя: чешуи чешую чешуя
дельфин: дельфина дельфинов
водный: водных
бока: бока
мир: мир
исследователь: исследователь исследователи исследователям
жировых: жировых
предназначение: предназначением
согласный: согласно
мелководный: мелководных
обнаружить: обнаружили обнаружить
плавник: плавники
кальций: кальция
обозначен: обозначен
посчитать: посчитал
человек: людей
покрывать: покрывали
обозначены: обозначены
мозазавр: мозазавр
впервые: впервые
сильный: сильно
черными: черными
фосфор: фосфора фосфором
название: название названием
сохранившимися: сохранившимися
обозначена: обозначена
дополнительный: дополнительных
хрустальный: хрустального
простой: простые
шероховатый: шероховатая
эрс: эрс
массы: масс
достигать: достигала
тонкий: тоньше тонким
движение: движения
мощный: мощная
челюсть: челюстями
костный: костная
защита: защиту защита
меря: мере
выйти: вышла
любой: любом
накопление: накоплению
рыба: рыбам рыб
дорсет: дорсет
основа: основа
неопределенные: неопределенные
описание: описанием
отмечен: отмечен
отмечены: отмечены
связана: связана
плоский: плоскими
борозда: борозд
территория: территории
туловище: туловище туловища
отыскать: отыскала
использовать: использовали использовать
