зеленые: зеленые
меченый: меченого меченый
научный: научных
микоризной: микоризной
иметь: имеют
семя: семян
ананас: ананаса
поступающие: поступающие
обнаружить: обнаружили
времен: времен
листочек: листочки
степень: степени
неутешительный: неутешительному
чарльза: чарльза
добавить: добавить
содержать: содержала
орхидная: орхидная
одна: одна
десятилетие: десятилетия
зажечься: зажглись
скептический: скептической
польза: пользу
орхидные: орхидные
выбрасывать: выбрасывают
вырастить: вырастишь
род: рода
наличие: наличии
поток: потоки
такой: такого таких такими
рост: рост
основа: основе
дальний: далее
протокормов: протокормов
огромный: огромное огромные
отпрыск: отпрыскам отпрысков
маленький: мал
основный: основные
передавать: передают
вещество: веществ веществами
призывать: призывает
условие: условиях
биолог: биологов биолог
радиоактивно: радиоактивно
оказываться: оказывалось
небольшой: небольшое
молодой: молодой молодые молодых
усвоить: усвоили
пальчатокоренник: пальчатокоренник
гораздо: гораздо
казеин: казеина
изолированный: изолированных
растущими: растущими
симбионт: симбионт
особь: особями
контролировать: контролирует
забота: заботы
недостаток: недостатки
точка: точка
замечание: замечание
ограничение: ограничению ограничение
находиться: находились находится
проверить: проверила
оставаться: оставались
часть: часть
впоследствии: впоследствии
понять: понять
овсяный: овсяный овсяно овсяном
осторожный: осторожно
возможный: возможную возможно возможна
лабораторный: лабораторного
зафиксированного: зафиксированного
усиливать: усиливало
замедлять: замедлял
светиться: светится
водный: водном
выявить: выявил
сложный: сложным сложны
расти: расти
найти: нашли
богатство: богатством
яркий: ярко
новость: новость
задается: задается
автор: автора авторами
дарвина: дарвина
меченный: меченный
опутать: опутал
протяжение: протяжении
мицелий: мицелий
термин: термины
скорый: скорее
свидетельство: свидетельство
сеть: сеть сети сетей
раствор: раствор
постулировать: постулирует
реакция: реакции
критикующая: критикующая
посредничество: посредничество
произрастающие: произрастающие
грибной: грибную грибной
имевшие: имевшие
нижний: нижним
прямой: прямой
вопрос: вопросом
оценка: оценкой
протокормом: протокормом
лёгкий: легко
европа: европе
комнатный: комнатное
зафиксировала: зафиксировала
сразу: сразу
россия: россии
момент: моменту момент
фиксировать: фиксировала
получившаяся: получившаяся
править: правило
западный: западной
наблюдение: наблюдения
гидроксида: гидроксида
способный: способный
первый: первое
симбиотический: симбиотический
зеленая: зеленая
назвать: назвать
контролем: контролем
читатель: читателями
дарвин: дарвин
состав: составом
совместительство: совместительству
умеющие: умеющие
журналист: журналистами
георгий: георгий
формируется: формируется
резкий: резко
причудливый: причудливой
годов: годов
калий: калия
доказанный: доказано
связь: связь связью
исследователь: исследователей исследователи
контекст: контекст
информация: информацией информации
разветвленнее: разветвленнее
прилететь: прилетели
главный: главный
образовать: образует образуют
дискурс: дискурс
прийти: пришла
биоценоз: биоценоза
прорастание: прорастания
кредит: кредит
согласный: согласна согласен
поместить: поместили
накапливать: накапливали
справедливый: справедливо
подвергнуты: подвергнуты
метафора: метафора
авторадиография: авторадиография
чистый: чисто
сайт: сайта
протокорм: протокорм
передача: передачи
фотосинтезе: фотосинтезе
обсуждаемая: обсуждаемая
успевший: успевший
водяном: водяном
создаваться: создавалось
натрий: натрия
активированный: активированный
натянутый: натянута
контактировали: контактировали
коммуникация: коммуникация
объект: объект объектом
органический: органическими
группа: группой группы группа
приклеенная: приклеенная
англ: англ
помощь: помощи
консенсусной: консенсусной
расцветка: расцветок
гидрокарбонат: гидрокарбонат
распределение: распределению
радионуклида: радионуклида
особый: особая
пусть: пусть
протокормы: протокормы
гипотеза: гипотезы гипотеза гипотез
зеленое: зеленое
открытый: открытые
экспозиция: экспозиции
повестка: повестку
трубка: трубкой
настоящий: настоящем
вначале: вначале
ученым: ученым
кислота: кислоты
органика: органика
кстати: кстати
выражен: выражен
делиться: делиться делится
обратить: обратите
проверка: проверки
фаза: фазе
отращивать: отращивает
жюстин: жюстин
микоризу: микоризу
миро: мире
гидролизат: гидролизат
переноситься: переноситься
британский: британских британским
пространство: пространства пространством пространстве
лес: леса
осуществляющей: осуществляющей
землянин: землян
удалось: удалось
получены: получены
целенаправленный: целенаправленном
удачный: удачная
идея: идея
потомство: потомстве
интернет: интернета интернете интернету интернет
зелеными: зелеными
герметичный: герметично герметичных
статья: статьи статье статья
чарльз: чарльз
дискуссия: дискуссий
сложнее: сложнее
связанный: связанный
микоризного: микоризного
гифами: гифами
подрастать: подрастали
ланолин: ланолином
масштаб: масштабах
рис: рис
взрослый: взрослого взрослой взрослая
поддержка: поддержку
удивляться: удивлялся
результат: результаты результате результата результатов
выбирать: выбирать
серьезные: серьезные
безводный: безводным
концепция: концепция концепцию
десяток: десятки
выразиться: выразиться
уход: ухода
обладая: обладая
прийтись: пришлось
маленькая: маленькие
брать: берут
симбионта: симбионта
описанный: описанный
источник: источник
следовательно: следовательно
успеть: успела
уметь: умеет
витамин: витаминов
целый: целого
кабель: кабелем
цветок: цветка цветок
единый: единую единой
дизайн: дизайн
обмен: обмен
зрение: зрения
контакт: контакт
зеленому: зеленому
ним: ним
похожий: похоже похожи
побег: побег
пространственный: пространственному
впечатление: впечатление
журнал: журнале
ятрышниковые: ятрышниковые
фотосинтеза: фотосинтеза
уровень: уровень
противник: противников
вид: вида виде
счет: счет
состоять: состоит
проблема: проблемы
совершенный: совершенно
изобретение: изобретения
фукса: фукса
зрелый: зрелые
впервые: впервые
некоторые: некоторыми
нашими: нашими
агар: агар
обозначить: обозначили
монголия: монголии
культивирование: культивирования культивирование
питаться: питается
локальный: локальную
послужить: послужил
использовав: использовав
метка: метки
ограниченный: ограниченная
форма: формой
гриб: гриба грибом гриб грибе
причина: причину
антропоморфизм: антропоморфизмами
наводить: наводит
новый: новые новыми новой новая
разделившая: разделившая
радионуклид: радионуклид
внесен: внесен
случать: случай
расстояние: расстояния расстоянии расстояниях
сок: сок
сформировал: сформировал
зафиксированный: зафиксированный
попавшего: попавшего
орхидея: орхидея орхидей орхидеи орхидеей
широта: широтах
очередной: очередной
произрастающая: произрастающая
итог: итоге
правда: правда
семейство: семейство
микориза: микориза
войти: войти
кормить: кормить
выплачивать: выплачивают
вверху: вверху
процесс: процессом процесс
обильный: обильно
синтезированных: синтезированных
куракин: куракин
современный: современные
авторадиографии: авторадиографии
накопить: накопить
показывать: показывает
карст: карст
показать: показали
доза: дозу
сцинтилляционного: сцинтилляционного
обеспечивать: обеспечивать
проросток: проростки проросткам проросток проростков
удивлять: удивляло
никто: никто
заботиться: заботиться
помимо: помимо
недавний: недавнего недавней
высказанной: высказанной
оказаться: оказалось оказались окажется
одному: одному
базидиомицетового: базидиомицетового
симбиоз: симбиоз
час: часа
тесный: тесно
ветер: ветром
углерод: углеродом углерод углерода
микоризных: микоризных
приступать: приступать
верхний: верхнем
газ: газа газ
жидкостный: жидкостного
короткий: коротких
эвм: эвм
отличаться: отличается
способность: способность способностью
путь: пути
мысль: мысль
реальность: реальности
образующего: образующего
обойти: обойти
спешить: спешить
объяснять: объясняет
соединить: соединили
эксперимент: эксперимент эксперимента
слой: слоем
вывод: выводу выводами вывод
возможность: возможность
разговор: разговоре
лесной: лесного лесном лесному
зависимость: зависимости
количество: количество
частить: части
второй: вторую
проникать: проникала
думать: думали
уголь: уголь
чрезвычайный: чрезвычайно
экологический: экологическую
пассивный: пассивной
сделать: сделали
подкармливать: подкармливает подкармливают
путем: путем
значительный: значительной
являться: является
требовательных: требовательных
кювета: кюветы кювету
земля: землю
полноценный: полноценного полноценный полноценную
осуществляться: осуществляется
методологический: методологические
родительский: родительской родительского
слабый: слабо
развитие: развития
агаре: агаре
счёт: счета
биогеоценозе: биогеоценозе
минимум: минимум
концентрироваться: концентрируются
химический: химической
тип: типа
единственный: единственная
почва: почве
приобретать: приобретает
боксы: боксы
актуальность: актуальность
комментарий: комментарий
транспорт: транспорта транспорт
часы: часов
представленный: представлен
внимание: внимание
экспериментальный: экспериментальный экспериментальные
гифы: гифы
рисунок: рисунок
гарантировать: гарантирует
меченным: меченным
фотосинтезировать: фотосинтезировать
ткань: тканях
связывающей: связывающей
получаться: получается
мочь: могли
появиться: появится
связаны: связаны
общий: общую общая общий
фотосинтезу: фотосинтезу
добиться: добиться
элемент: элементы
работа: работа
процент: процент
обсуждаемой: обсуждаемой
украина: украине
существование: существование
популярный: популярный
весьма: весьма
падать: падает
пленка: пленка
вобрав: вобрав
бактерия: бактерий
свой: свой своим
цветки: цветки
помогать: помогает
эффект: эффекта эффект
называться: называется называться
начнет: начнет
отношение: отношения
агара: агара
подсеяли: подсеяли
радиоактивный: радиоактивный радиоактивной радиоактивного
который: которое которым
лист: листьями листья
горшок: горшке
широкомасштабный: широкомасштабный
распространение: распространения
интригующий: интригующей
инопланетянин: инопланетяне
комплекс: комплекс
пропитываться: пропитывался
зеленой: зеленой
попадать: попадает
среда: среды среду
бокс: бокс
комочек: комочки
молочный: молочной
нутриентами: нутриентами
кластеризуются: кластеризуются
микоризный: микоризный
другой: другого
продолжительность: продолжительность
тысяча: тысячи
располагаться: располагались
протокормами: протокормами
изотоп: изотопом
выглядеть: выглядят
высказанная: высказанная
кормление: кормлении
питательный: питательных питательными питательные питательной
семенить: семени
закрытый: закрытые закрыты
схватить: схватить
радиация: радиации радиацией
связавший: связавший
большинство: большинство
легких: легких
подсадить: подсадили
нефотосинтезирующих: нефотосинтезирующих
фото: фото
изложены: изложены
углекислый: углекислого углекислый
суть: сути
показывающая: показывающая
показывая: показывая
середина: середине
казахстан: казахстане
срастись: срастись
должный: должны
выделиться: выделился
материнский: материнского материнское материнской материнская
растение: растения растений растением растение растению растениями
аспект: аспекте
разный: разную
перестать: перестанет
