ним: ним
второй: вторых
характерный: характерно
намекать: намекает
высокий: высоких выше
состоять: состояли состоял
ошибочный: ошибочно
центр: центре
фиксировать: фиксировал
зависеть: зависел
лейцин: лейцин
сомнение: сомнениям сомнения
разрезающих: разрезающих
результат: результатам результате результаты
годы: годы
оставаться: остаются оставалось
органику: органику
древний: древней древнее
манипуляция: манипуляцию манипуляция
градиент: градиентов градиент
никой: ником
выжить: выжили
человек: человека
сформирован: сформирован
очевидный: очевидно
абсолютный: абсолютные
углерод: углерода
модификация: модификации
активный: активно
стать: стало
вирус: вирусами вирусов
проследить: проследить
важный: важно
обширный: обширный
биоинформатиков: биоинформатиков
итог: итоге
сложный: сложным сложный
бороться: бороться
тип: тип
удалось: удалось
окисление: окисления
блокированию: блокированию
вещество: веществ
кассета: кассеты
живой: живых живой
создаваться: создавался
синтетаз: синтетаз
доступный: доступен
вообще: вообще
вывод: выводы
белка: белок белки белка
гираза: гираза
механический: механическое
ослабляющей: ослабляющей
размер: размер
поддерживать: поддерживает поддерживал
палочковидную: палочковидную
форма: форму
метаболизм: метаболизм
хемолитоавтотрофом: хемолитоавтотрофом
патрик: патрик
точный: точно точные
относительный: относительно
биохимия: биохимии
непосредственный: непосредственно
основание: оснований
ацетогенов: ацетогенов
ацетогенного: ацетогенного
высокоорганизованного: высокоорганизованного
метаболический: метаболический
эукариотам: эукариотам
внутренний: внутренней
ацетогена: ацетогена
прокариотам: прокариотам
белковый: белков
консервативный: консервативных
нуклеотид: нуклеотидов
взгляд: взгляд взгляду взглядами
автор: авторы авторов автор
происхождение: происхождение происхождения
субъединицы: субъединицы
сходный: сходных
давным: давным
кислородный: кислородной
кстати: кстати
рис: рис
достаточный: достаточно
британский: британским
биохимик: биохимиком
многие: многих многом
граница: границу
длина: длины
проводиться: проводятся
гиразы: гиразы
возраст: возраст
иметь: имела имел имеем
показать: показали
липидов: липидов
граму: граму
отсутствовать: отсутствовал
попасть: попасть
тяжелой: тяжелой
подход: подхода
верхний: верхнюю
обычный: обычной обычная обычным
ферредоксин: ферредоксин
практически: практически
предположительно: предположительно
представление: представления представление
доминировавшему: доминировавшему
получаться: получается
поликетидов: поликетидов
уязвимость: уязвимостью
момент: момент
комбинироваться: комбинируются
выполнять: выполнял
идентифицированы: идентифицированы
напряжение: напряжение
поздний: поздней
собственный: собственно
цитохромоксидазы: цитохромоксидазы
сомневаться: сомневаются
связанный: связанных
эволюционный: эволюционного эволюционные эволюционный
обитатель: обитателя
период: период
впереди: впереди
перепадать: перепадала
заключенный: заключенный
образоваться: образовались
список: список списка
пережить: пережить пережил
абиотического: абиотического
органический: органический
современник: современникам современники
разойтись: разошлись
гипотеза: гипотезой
возникнуть: возникла возникли
липидной: липидной
окислительный: окислительном
защищать: защищать
организм: организмов организм организмом организма
дальний: далее
энергия: энергии энергию
сильный: сильно
разорванный: разорванный
признак: признаки
синтезировать: синтезирует
связаны: связаны
найденный: найденный
замкнутый: замкнутым
цианидом: цианидом
состоящей: состоящей
сложность: сложности
ацетогены: ацетогены
составлять: составлял
полностью: полностью
исходный: исходный
такой: такую таких такими таким
особенность: особенности
мочь: могла могло могли
субъединиц: субъединиц
соответственный: соответственно
косвенный: косвенные
планета: планету
приводить: приводит
работать: работает
вид: видов
существ: существ
скорость: скорости
тема: тему
готовый: готовой
протоклетки: протоклетки
доменов: доменов
дать: дала
основанный: основан основанное
ветвь: ветвей
журнал: журнале
самопроизвольный: самопроизвольно
доверительный: доверительный
подвергаться: подвергаются
компонент: компонентов компонент компонентом
крупный: крупных
расчеты: расчеты
окраска: окраску
спиртовой: спиртовое
полакомиться: полакомиться
насколько: насколько
молочнокислое: молочнокислое
оксидоредуктаза: оксидоредуктаза
уровень: уровню
прокариот: прокариот
геном: геномов геноме геномам генома
остаться: остались остаться остался
первый: первых первыми первую первым
железо: железо
представляться: представляется
гликолиз: гликолиз
выброс: выбросов
считать: считают
серый: серым
каждый: каждого
хемоавтотрофными: хемоавтотрофными
нежели: нежели
облик: облике облика
вполне: вполне
выделенный: выделены
показывающие: показывающие
вызывать: вызывает
лейном: лейном
гомоцитратсинтаза: гомоцитратсинтаза
графическое: графическое
присутствовавших: присутствовавших
возможность: возможности возможность
атф: атф
замена: замен
событие: событие
судя: судя
биосинтез: биосинтеза
требуемый: требуемых
филогенетическое: филогенетическое
проделав: проделав
либо: либо
корень: корнем
польза: пользу
обсуждаемой: обсуждаемой
умелый: умел
метаболические: метаболические
реконструировать: реконструировать
основный: основных
зависимый: зависимый
серный: серные серный серных
пар: пары пар
осуществляться: осуществлялась
поменять: поменяли
избыточный: избыточное
незамкнутым: незамкнутым
интересный: интереснее
прогеноте: прогеноте
экстраполировать: экстраполировать
привычный: привычные
неизвестный: неизвестно
катастрофа: катастрофы
сотня: сотнями
мембранной: мембранной
ранее: ранее
считаться: считалось
означать: означало
заключение: заключении
ныне: ныне
анализируемых: анализируемых
цитоскелет: цитоскелет
микроскоп: микроскопом
кетоглутаратсинтаза: кетоглутаратсинтаза
кислород: кислород
эукариоты: эукариоты
способ: способ
архейные: архейные
биосфера: биосферы
палочковидным: палочковидным
микробных: микробных
окаменелость: окаменелостей
биоинформатики: биоинформатики
вуда: вуда
отличие: отличие
каталитический: каталитической
никелевый: никелевая
давать: давать
предок: предка предку
основа: основе
идентифицируют: идентифицируют
представлять: представлял
связана: связана
портрет: портрет
исчерпываться: исчерпывался
подобный: подобно
сразу: сразу
протонный: протонный
покрывать: покрывает
сайт: сайта
организованный: организован
жизнь: жизни
прямой: прямых
представитель: представителей
обстоять: обстоит
характеризоваться: характеризовался
протоорганизм: протоорганизм
соединяющий: соединяющий
восстановленный: восстановленный
обнаружение: обнаружение
процесс: процессов
частить: части
получать: получать получал
вычислить: вычислят
найти: нашли
подсчете: подсчете
выйти: вышло
аналогичный: аналогично
сюрприз: сюрприз
термофильным: термофильным
бомбардировка: бомбардировки бомбардировка бомбардировку
свидетельство: свидетельств свидетельства
соединяющими: соединяющими
идущие: идущие
исследователь: исследователи исследователей исследователями
протон: протонов
частность: частности
возможный: возможным возможно
триптофан: триптофан
умение: умениями
глюконеогенез: глюконеогенез
обратить: обратите
аналогия: аналогии
млрд: млрд
конец: конца
фиксируя: фиксируя
органикой: органикой
вместо: вместо
нуклеиновых: нуклеиновых
резкий: резко
помощь: помощью
предположение: предположение
последний: последнего последние последнее
протонных: протонных
скептический: скептическими
информация: информации
специфический: специфическое
счет: счет
последовательность: последовательностях последовательности последовательностей
противоположность: противоположность
наполовину: наполовину
очередь: очередь
аминоацил: аминоацил
часть: часть частью
наверняка: наверняка
внимание: внимание
косвенно: косвенно
совершенный: совершенно
эффективный: эффективна
схема: схема
используются: используются
населять: населяла
правда: правда
архей: архей
льюнгдаля: льюнгдаля
кребса: кребса
электрон: электроны
изучение: изучении
функция: функцию
термофильных: термофильных
археи: археи
атмосфера: атмосфере
чужеродный: чужеродную
скопление: скопления
мешочек: мешочки
оценить: оценили
тирозин: тирозин
аналог: аналогов
новость: новостью
бактерия: бактерий бактерии бактериям
происходить: происходят
выдавать: выдавало
создающий: создающий
скручивающий: скручивающий
согласоваться: согласуется согласуются
предкового: предкового
похвастаться: похвастаться
заметить: заметить
гомологов: гомологов
эффекторных: эффекторных
археям: археям
большинство: большинства
углекислый: углекислый
состав: состав
упомянутой: упомянутой
посвященная: посвященная
клеточный: клеточных клеточной клеточная клеточного
клетка: клетками клеток клетки клетках
реконструироваться: реконструируются
датировка: датировка
дальнейший: дальнейшем
интервал: интервалы интервал
пружина: пружину
брожение: брожения
который: которую
тысяча: тысячами
сторона: сторону
микроскопический: микроскопических
слово: слово
трех: трех
фиксирующие: фиксирующие
мочевина: мочевины
количество: количествах
фортер: фортер
ошибка: ошибки
домена: домена
образовать: образуют
живший: живший
источник: источниках источников источнике источник
восходящий: восходящими
аминокислота: аминокислот
трансляция: трансляция
реконструкция: реконструкция реконструкции реконструкцией
остается: остается
ацетон: ацетон
загвоздка: загвоздка
рыба: рыбы
ключевой: ключевой
неточны: неточны
предположить: предположить
минеральный: минеральных минеральные минеральный
валин: валин
миллиард: миллиардов
выделяться: выделялся
горизонтальный: горизонтального
потомок: потомков потомки
молекулярный: молекулярных
трнк: трнк
использовать: использовал
позволять: позволяют
явный: явно
появиться: появилась
испытывать: испытывают
гомологи: гомологи
число: числе
неожиданный: неожиданными
кокк: кокком кокка
живущий: живущих
существование: существовании существования
терпеноидов: терпеноидов
восстановить: восстановить
кислота: кислот
геохимический: геохимических
оказаться: окажутся оказался
целый: целых
видный: видно
случиться: случилась
стерилизующий: стерилизующий
цикл: циклом цикла цикле цикл
необходимый: необходимых
хемогетеротрофными: хемогетеротрофными
нынешний: нынешней
рост: роста
понять: понять
система: систему системы системе
выяснить: выяснить
накопление: накопления
смысл: смысле смысл
мощный: мощный
древние: древними
прежние: прежние
какой: какую какое
фиксация: фиксации
черных: черных
назвать: назвали
показывать: показывают
актину: актину
согласный: согласно
откуда: откуда
присутствие: присутствие
предыдущий: предыдущие предыдущее предыдущей
тот: той
подводный: подводных подводными
глубокий: глубоким
знаменитый: знаменит
выделять: выделял
охарактеризовать: охарактеризовали
присутствовать: присутствуют присутствовали присутствует присутствовал
стабильность: стабильность
пирита: пирита
ножницы: ножницы
существовать: существовать существует существовали
эукариот: эукариот
часы: часов
работа: работе
произойти: произошли
вымерший: вымершим
современный: современных современной современным современными
горячий: горячих горячем
встроенный: встроен
температура: температурах
использовались: использовались
синтезируя: синтезируя
ацетогенами: ацетогенами
перенос: переноса
филогенетические: филогенетические
временный: временные временных
поддерживаемой: поддерживаемой
настоящий: настоящего
история: история историей
ясный: ясен ясно
водород: водорода водород
реконструированной: реконструированной
экосистема: экосистема экосистемы
вопрос: вопрос
путем: путем
помимо: помимо
термин: термина
репертуар: репертуар
метода: методами метода методы
утрата: утрата
соответствующий: соответствующего
никакой: никакой
одну: одну
ацетогеном: ацетогеном
жившего: жившего
обратный: обратной обратная обратную обратным
скорый: скорее
структурный: структурно
необходимость: необходимости
инженерии: инженерии
анализ: анализа
изменить: изменить
указывать: указывали указывает указывать
компания: компании
метаболизме: метаболизме
обнаружено: обнаружено
обладать: обладал
получившая: получившая
эффект: эффект
палочка: палочкой палочка палочки
способность: способность
синтрофных: синтрофных
палочковидный: палочковидный
волновать: волнует
фермент: фермент фермента ферментами ферментов
соответствовать: соответствовал
задолго: задолго
жалкий: жалко
прокариотами: прокариотами
данные: данные
перевод: переводе
название: название
кодировать: кодировал
метаболических: метаболических
крутиться: крутится крутился
анаэробом: анаэробом
мир: мир
ацетат: ацетат
промежуток: промежутках
примерно: примерно
бактериальный: бактериальные бактериального
передающего: передающего
образ: образом образ
обнаруживаться: обнаруживается
оценка: оценка
биоинформатические: биоинформатические
курильщик: курильщиков
лингвист: лингвисты
обеспечивающие: обеспечивающие
консенсус: консенсуса
ген: генов гены гена генами
восстановительный: восстановительном
выглядеть: выглядеть выглядел
земной: земная земной земного
цитоскелетный: цитоскелетный
подтвердить: подтвердила
таковой: такового
обнаружить: обнаружить
представленный: представлена представленной
гидрогеназа: гидрогеназа
мембрана: мембрану мембраны
дело: дело деле
фосфолипидов: фосфолипидов
генетический: генетического генетическое
оставить: оставили
рисунок: рисунок
составить: составить
путь: путь пути путей
семейство: семейств
обитать: обитал
структура: структур
новый: нового новая новом новые новую новой
единственный: единственный единственным
установить: установить
полуживой: полуживой полуживого
одним: одним
прикладной: прикладном
сукцинатдегидрогеназа: сукцинатдегидрогеназа
океан: океана
куракин: куракин
единый: единому
набор: наборов набор
протоклетках: протоклетках
массивный: массивная
генный: генной
оказываться: оказываются
земля: земле земли
возникновение: возникновения
рнк: рнк
удивительный: удивительного
физиология: физиологии
выполненная: выполненная
синтазы: синтазы
сравнение: сравнении
кода: кода
обособленный: обособленных
вероятный: вероятными вероятно
резать: резали
получить: получить
наличие: наличие наличию
вулкан: вулканов вулканами
астероидная: астероидная
время: времена
линия: линий
ждать: ждут
загадка: загадкой
дупликации: дупликации
похожий: похоже
открывать: открывает
весь: всей
эксперт: эксперты
гиразе: гиразе
начаться: началась
взаимоисключающие: взаимоисключающие
эпоха: эпоху
биоинформатического: биоинформатического
газ: газ
гомологичны: гомологичны
получиться: получился
заселить: заселили
превращение: превращению
кетоглутарат: кетоглутарат
белок: белком
полноценный: полноценный
правый: правой
углевод: углеводов
полутора: полутора
неорганический: неорганических
например: например
логичный: логично
построить: построить
регулярный: регулярно
стадия: стадии
тесный: тесно
некаталитической: некаталитической
делать: делать
исследование: исследования исследовании исследование
жила: жил
большой: большом
вряд: вряд
днк: днк
распознавание: распознавание
условие: условий
больший: большие
прокариотом: прокариотом
дерево: дерево дерева
выделяющие: выделяющие
повторно: повторно
филогении: филогении
гомологичный: гомологичный
глава: главу
общий: общего общему общем
отмечаться: отмечалось
прикинуть: прикинуть
факт: факт
известный: известных
черным: черным
предполагать: предполагают
думать: думаем
внешний: внешнем внешние
повышать: повышает
статья: статье статья статьи
неясный: неясно
метаногенов: метаногенов
кишечный: кишечной
специфичного: специфичного
георгий: георгий
