паразит: паразитами паразиты паразита паразитов
атакующие: атакующие
угроза: угрозе угроза
важный: важно
размножающиеся: размножающиеся
попадаться: попадаться
такой: такого таких таким
конец: конец
обладающих: обладающих
внутренность: внутренности
тело: тело теле тела телах телам
проглотить: проглотит
защищать: защищать защищают
опасный: опасных опасного
дать: дало
сопоставимый: сопоставимых
стать: стать
выступать: выступают
тракт: тракт
запас: запасов
конкурентный: конкурентной конкурентно
обеспечение: обеспечения
нужда: нужд
муравей: муравьи
редию: редию
изученных: изученных
возраст: возраста
обратиться: обратиться
успешный: успешного успешное успешно
доминирование: доминирование
редия: редия
кооперация: кооперации
жертва: жертв
церкария: церкария
университет: университете
выявить: выявили выявить
проток: протоки
помощь: помощи помощью
заметный: заметно
экологический: экологическую
мелании: мелании
лабораторный: лабораторных
разделение: разделения разделение
вылупившийся: вылупившийся
оперировать: оперирует
переход: перехода
линия: линии
прямой: прямых
шарик: шарики
морфологически: морфологически
регулярный: регулярно
знание: знаний
крепость: крепости
примерно: примерно
темное: темное
роль: роли
поиск: поисках поиски
стоять: стоит
черными: черными
ресурс: ресурсов
поисковый: поисков
стерильный: стерильны
отличный: отличной
дочерний: дочерняя дочерней
эусоциальность: эусоциальность
совокупный: совокупной
статья: статьи
длинный: длинный
мирацидии: мирацидии
ради: ради
птица: птица птицам
зародышевый: зародышевой
раствор: раствором
паразитировать: паразитируют
мкм: мкм
первый: первым первых
развитой: развитым
вроде: вроде
глотка: глотка глотки
цикл: циклом цикл циклу
выделить: выделить
размер: размеров размера размерам
попав: попав
казаться: кажутся
трех: трех
размножающимся: размножающимся
принцип: принципе
личинка: личинка личинки личинок
доля: доля
неприхотливость: неприхотливости
длина: длина
проникновение: проникновения
социальный: социальная
стрелок: стрелками
использующих: использующих
миллион: миллионы
диего: диего
химический: химического
разделяющих: разделяющих
церкарии: церкарии
начать: начать
мариты: мариты
поколение: поколения
содержание: содержании
следующий: следующего
тропический: тропических
гликогена: гликогена
структура: структура
отказываться: отказывается
крупный: крупных крупным
размножающихся: размножающихся
ряд: ряда
приходить: приходят
новый: новых
составлять: составляла
любительский: любительских
сравнивая: сравнивая
меря: мере
метацеркарии: метацеркарии
развиваться: развивается
конечный: конечном
обратить: обратите
свободноживущего: свободноживущего
эусоциальные: эусоциальные
развитие: развития развитию развитие
страна: странах
вместительный: вместительным
минимум: минимум
самый: самых
возможность: возможность
неразмножающиеся: неразмножающиеся
любой: любого
благодаря: благодаря
выявлены: выявлены
заполненные: заполненные
трипсов: трипсов
центральный: центральной
защитный: защитных
распространены: распространены
поражающий: поражающих
защита: защита защиты
членистоногих: членистоногих
морской: морских
обусловливать: обусловливать обусловливает
четверть: четверть
обитание: обитания
двустворчатый: двустворчатый
питаться: питается
социобиологии: социобиологии
последний: последние
позвоночный: позвоночных
вода: воде
случай: случае
трематоды: трематоды
счет: счет
аппарат: аппаратом аппарат
отмечены: отмечены
нематоды: нематоды
эусоциальных: эусоциальных
окончательный: окончательного окончательным окончательных
например: например
вполне: вполне
значительный: значительно
возникающая: возникающая
атакующих: атакующих
полностью: полностью
этакий: этаким
путь: пути путей
марита: марита
способность: способность
клон: клонов
четкие: четкие
калифорний: калифорнии
отбор: отбор
паразитический: паразитические паразитических паразитическая
промежуточный: промежуточные промежуточным промежуточного промежуточных промежуточный промежуточными
изначальный: изначально
нормальный: нормальные нормальных
предложенной: предложенной
способствовать: способствовать способствует
чей: чья
лунка: лунки
подсчитывать: подсчитывали
метацеркария: метацеркария
планшет: планшета планшет
вопрос: вопросов
выступить: выступить
сообщество: сообществах
развиться: разовьются
образ: образом
незрелый: незрелых
раз: раза
исследование: исследования
являться: являются является
контроль: контроль
занимать: занимают
зрение: зрения
родственный: родственным родственный
сородич: сородичей сородичам
внутри: внутри
трематодам: трематодам
сдерживания: сдерживания
труд: труда
ним: ним
проходить: проходят
энциртид: энциртид
брюхоногий: брюхоногий
специализированной: специализированной
отличие: отличие
массы: массы
точка: точки
рисунок: рисунок
собственный: собственного собственных
трематоду: трематоду
обнаружено: обнаружено
разнообразный: разнообразны
ротовой: ротовым ротовой
называемой: называемой
четко: четко
размножение: размножения размножение
отправиться: отправится
поведение: поведению поведением
азия: азии
огромный: огромная огромной
условие: условиях
половой: половые половым
высокий: высокой
игнорировать: игнорировали
внешний: внешние
орган: органах
заражать: заражать
биология: биологии
включающим: включающим
заселять: заселяют
ресничный: ресничного
институт: института
ингибирования: ингибирования
всасывать: всасывают
различие: различия
легкие: легкие
скорый: скорее
редии: редии
наездник: наездников
трематод: трематод
включая: включая
чрезвычайный: чрезвычайно
дальнейший: дальнейшем дальнейшее
морфологический: морфологические
прогрызать: прогрызают
формируются: формируются
сравнение: сравнении
помещать: помещали
разводить: разводить
опасность: опасности
изредка: изредка
колония: колониях колонии колонию
угодный: угодно
мирацидий: мирацидий
камера: камере
улитка: улиток улитки улитку
сомнение: сомнение
особь: особи особей особями
производить: производит
отношение: отношению
хозяин: хозяев хозяева хозяином хозяина хозяевам хозяин
внимание: внимание
яростный: яростно
ставить: ставит
намного: намного
источник: источник
итог: итоге
железа: железы
согласный: согласно
шанс: шансы
новиковская: новиковская
многочисленный: многочисленны
человек: человека
годы: годы
ген: гены
представитель: представителями представителей
инструмент: инструментами
домашние: домашних
превратиться: превратиться
показательный: показательны
найти: нашли
шистосомы: шистосомы
похожий: похожа похожих
африка: африки
создает: создает
получение: получения
класс: класс
вид: видов виде вида
жертвующих: жертвующих
разрывая: разрывая
враг: врагов
общественный: общественных
означать: означает
ранее: ранее
стадия: стадий стадия
взгляд: взгляд
часть: часть
червь: черви червей червь червя червям
мелкий: мелких мельче
другой: другими другую другим
специальный: специального
пищеварительный: пищеварительный
редий: редий
видимый: видимому видимо
превращаться: превращается
старый: старых
трематодами: трематодами
нагрузка: нагрузке нагрузкой
относительный: относительно
ученые: ученые
сильный: сильный
увеличивать: увеличивает
непостоянный: непостоянная
заражение: заражения заражение
характеристика: характеристиками
провести: провели
след: следов
почка: почки
появление: появлению появлением
индивидуальный: индивидуальной
заразив: заразив
конкурирующую: конкурирующую
экзотический: экзотической
рыба: рыб рыба рыбу
специализация: специализацию
оказываться: оказываются
профессиональный: профессиональные профессиональных
плавать: плавать плавают
разовьется: разовьется
обнаружена: обнаружена
сан: сан
солдат: солдаты солдат солдата
эксперимент: эксперимент
появиться: появились
оказаться: оказались
вытеснены: вытеснены
немалый: немало
пример: примеров пример
жертвующие: жертвующие
покинув: покинув
обсуждаемой: обсуждаемой
впервые: впервые
заново: заново
несчастный: несчастных
нападать: нападают
продолжение: продолжение
приспособленность: приспособленностью
океанографии: океанографии
одни: одни
вызванный: вызвано
лягушка: лягушек
конспецификами: конспецификами
меч: мечом
изучение: изучение
различный: различных
успешность: успешность
путем: путем
род: рода родом
присутствовать: присутствуют присутствовала
число: числе
предыдущий: предыдущую
начиная: начиная
никак: никак
данный: данном
общий: общие общего общей
обнаруживать: обнаруживали
обнаружить: обнаружили
наибольший: наибольшее
землекоп: землекопы
простой: простыми проще
высасывая: высасывая
второй: второго вторых
обнаружены: обнаружены
мочь: могло
связанный: связанные связанной
доказанный: доказано
кишечник: кишечником кишечник
уничтожение: уничтожения
распространение: распространения
слово: словах
возможный: возможно
агрессия: агрессии
пресноводный: пресноводной пресноводных
объяснить: объяснить
пчел: пчел
физиологическим: физиологическим
понимание: понимание
какой: какое
плоский: плоских плоским плоские
называться: называется
феномена: феномена
южный: южной
экстремальный: экстремальный
эмбрион: эмбрионы
подсаживать: подсаживали
представлять: представляют
земля: земли
мариту: мариту
сайт: сайта
элемент: элементы
адаптаций: адаптаций
количество: количество
проявлять: проявляли
выявлено: выявлено
американский: американские
особа: особой
покоящаяся: покоящаяся
прийти: пришли
экстремальную: экстремальную
задача: задача
исследователь: исследователи исследователей
продвижение: продвижения продвижение
привести: привела
слева: слева
крошечный: крошечные крошечным
результат: результатом результатов результат результаты
пиявка: пиявок
насекомое: насекомых
худой: худой
сложный: сложным сложная сложному
спороциста: спороциста
спороцисты: спороцисты
центр: центре
потребоваться: потребоваться
фотография: фотографиях
основный: основном
скриппса: скриппса
сосед: соседей
масштабный: масштабных
взрослый: взрослые взрослая
пола: полами
анна: анна
термит: термиты термитов
обеспечивающих: обеспечивающих
выживать: выживает
практически: практически
высажены: высажены
страдать: страдают
родственник: родственников
моллюск: моллюск моллюска моллюсков
голый: голые
напоминать: напоминает
свой: своим
галловых: галловых
отрезок: отрезков
созданными: созданными
доставать: доставали
выводковой: выводковой
размножаться: размножаются
песчаный: песчаные песчаной
пожаловать: пожалуй
жизненный: жизненным жизненный жизненному
спороцисту: спороцисту
муравьев: муравьев
заканчивая: заканчивая
покров: покровы
бесценный: бесценными
небольшой: небольшой
отличаться: отличались
заражающей: заражающей
целовать: целую
конкурент: конкурентов
размножающимися: размножающимися
каста: касты каста
зафиксировано: зафиксировано
целый: целом
вероятный: вероятно
вытеснять: вытесняют
развивающийся: развивающиеся
вывод: выводу выводам
теория: теории
атаковать: атакуют атаковали
меньший: меньшей
обнаружение: обнаружение
собрат: собратьев
присутствие: присутствие
существами: существами
пчела: пчелы
млекопитающий: млекопитающих млекопитающим
яйцо: яйца
полость: полости
который: которую которым
защитник: защитники защитников
косвенный: косвенного
час: часа
здравоохранение: здравоохранения
встречающиеся: встречающиеся
либо: либо
аквариум: аквариумах
место: место местах
животное: животные животных
характерный: характерна
фундаментальный: фундаментальных
исключительный: исключительную
частить: части
калифорнийском: калифорнийском
присосавшихся: присосавшихся
справа: справа
