связана: связана
оказаться: оказалась оказались
достигнутый: достигнут
получить: получат получили
тысяча: тысячам
поток: поток
монте: монте
возвращаться: возвращается
прогресс: прогресс прогрессу
уровень: уровней уровень уровни
сверточные: сверточные
оглашение: оглашения
существование: существования
представлять: представляют
добиться: добились
цикл: циклов
стокгольм: стокгольме
центральный: центральной
развитие: развитие
говарда: говарда
идея: идея
секвенирование: секвенирование
участие: участии участием
престижный: престижной
подчеркнуть: подчеркнуло
оставаться: оставалось
предсказание: предсказание предсказания предсказаний предсказаниях
рамакришнан: рамакришнан
применение: применений применение
перемещение: перемещений
матричный: матричной
показать: показал показало
использующий: использующий
пример: примеры
появиться: появилось
энергия: энергии
закончить: закончить
итеративный: итеративно
секунда: секунды
совместный: совместно
одновременный: одновременно
определенный: определенный
биомедицины: биомедицины
полувековой: полувековой
получение: получения получение
широкий: широкому
очевидный: очевидна очевидно
место: месте
никто: никто
точка: точки
хассабиса: хассабиса
часть: часть
честь: честь
готовый: готовы
ранее: ранее
победить: победила
представление: представлениями представления
нерастворимый: нерастворимые
компьютерный: компьютерное компьютерных
выполнять: выполнять выполняют
вселенной: вселенной
находиться: находятся
специфичность: специфичностью
пройти: прошло
создать: создать создали
тело: тел
запись: записей
ингибитор: ингибиторы
живой: живом живой живых
спектроскопия: спектроскопия
порядок: порядок порядком порядке порядка
паттерн: паттерн
копиться: копились
дэвиду: дэвиду
годам: годам
стабилизация: стабилизации
каждый: каждого
решенные: решенные
суметь: сумели
третичной: третичной
верх: верх
трехмерной: трехмерной
научный: научной научного
сотня: сотни
длинный: длинные
найти: найти нашла
данные: данных
управляемый: управляемыми
усовершенствованный: усовершенствована
вскоре: вскоре
бейкеру: бейкеру
аминокислота: аминокислот аминокислоты
последовательный: последовательно
медицинский: медицинского
пептидные: пептидные
шахматы: шахматах
уилкинс: уилкинс
фермент: фермент ферментами фермента ферментам ферментов
расшифрованных: расшифрованных
меря: мере
незадолго: незадолго
текст: тексте
дороти: дороти
хассабисом: хассабисом
варить: варим
рис: рис
благодаря: благодаря
расшифровал: расшифровал
оптимизировала: оптимизировала
дизайнерский: дизайнерский
создавать: создавала
демис: демис
столетие: столетие
задача: задача задач задаче задачи задачам
история: историей
птицын: птицын
иерархический: иерархическое
секвенированы: секвенированы
скелет: скелетом
уникальный: уникальный уникальными
ген: генов гены
вирусный: вирусных
нуклеиновых: нуклеиновых
мерка: меркам
рентгеновский: рентгеновских
доступный: доступен
участник: участниками участники
сравнивая: сравнивая
дизайн: дизайн дизайне дизайна
ключевой: ключевую
знание: знаниями
карьера: карьеру
молекулярный: молекулярной молекулярные
главный: главная
таки: таки
гемоглобин: гемоглобина
биотехнологий: биотехнологий
заниматься: занимались
институт: института
обозначение: обозначения
называться: называется
удаться: удастся
придание: придание
поколение: поколения
функция: функциями функции функций
белок: белком
стрелок: стрелками
сборка: сборка
отправленный: отправлена
рибосоме: рибосоме
альбебетин: альбебетин
трудоемкими: трудоемкими
внимание: внимание внимания
направленный: направленной
короткий: короткие
фото: фото
бейкером: бейкером
образующих: образующих
сенсоры: сенсоры
инсулин: инсулина
назвать: назвал
природный: природного природным
попытка: попытках
интеллект: интеллекта интеллектом интеллекту
цепь: цепи
опускаться: опускается
память: памяти
объединять: объединяла
качество: качестве качеству качества
случай: случаях случаев случае
закрепить: закрепило
принцип: принцип принципах
вольный: вольны
сша: сша
одинаковый: одинаковым
вплоть: вплоть
множественный: множественного
алгоритм: алгоритмов алгоритмы
ряд: ряда
принести: принесла
рса: рса
согласный: согласно согласны
модель: модели моделей
изучение: изучение изучения
предсказать: предсказать
вперед: вперед
мокрый: мокрым
реакция: реакции
целевые: целевые
переработана: переработана
наноматериалы: наноматериалы
определить: определил
максу: максу
мочь: можем могли
особа: особой
распознавание: распознавания
сделать: сделало
получающегося: получающегося
физический: физическая
белка: белки белка белок белку
показаны: показаны
анфинсен: анфинсен
удостоен: удостоен
строение: строение
тесный: тесно
заметный: заметно
принципиальный: принципиального принципиально
известный: известны известных известные известную известна известно
соседний: соседними
биологический: биологических биологические
хопфилд: хопфилд
фундаментальный: фундаментальную
египетский: египетские
альтернатива: альтернативы
михаил: михаил
анализ: анализа анализ
определяться: определяется
предсказательной: предсказательной
нуль: нуля
создание: создание создания создании
общий: общие общую
лигандами: лигандами
растворяться: растворяются
час: часа
достигать: достигала
модуль: модуле
подчеркивает: подчеркивает
напрямую: напрямую
терять: теряет
плодотворный: плодотворных
действительность: действительности
цепочка: цепочки цепочке цепочка
днк: днк
имен: имен
победитель: победителей
максимум: максимум
биосинтез: биосинтез
сторона: стороны
оперировать: оперирует
предсказанных: предсказанных
френсиса: френсиса
абсолютный: абсолютно
приближение: приближении
треугольник: треугольников треугольники
метода: методам метод методы метода методами
сильный: сильно сильных
расти: росло расти
доля: доли
расшифровка: расшифровка
изобретатель: изобретатель
замечать: замечать
остаток: остатки остатков остатками
спираль: спирали спиралей спиралями спираль
синтез: синтеза синтез
механизм: механизмов механизма
строгий: строго
целый: целом
соединенных: соединенных
образ: образом образов
архитектура: архитектура
ученым: ученым
реальный: реально реального
символичный: символично
игрок: игроков
помимо: помимо
постепенный: постепенно
создатель: создатель создателей создателю
двумерной: двумерной
раз: разом
мир: мир
выделить: выделил выделить
элемент: элементы
прийтись: пришлось
соединение: соединений
некоторые: некоторые некоторых
заданный: заданной
линн: линн
добавляться: добавляются
полипептидной: полипептидной
двухмерную: двухмерную
практический: практическое практические
переданной: переданной
разный: разных разные
простимулируют: простимулируют
время: временем
полезный: полезной полезные
свободный: свободном
разворот: разворотов
описывать: описывают
созданная: созданная
бейкера: бейкера
джеффри: джеффри
присуждена: присуждена
подвижный: подвижные
друг: друг друга
депонированных: депонированных
физиология: физиологии
своеобразный: своеобразно своеобразного
связанный: связанных связан
извлечение: извлечение
обратный: обратной
потребоваться: потребуется
вода: воде
луч: лучей
связано: связано
редкий: редких
небывалый: небывалой
перестает: перестает
разобраться: разобрались
высокомолекулярных: высокомолекулярных
четвертичная: четвертичная
глобулярные: глобулярные
исследование: исследования исследований
ион: ионов ионами
успех: успех успехов
гидрофобности: гидрофобности
догма: догме догмой
стейцем: стейцем
камень: камня
другой: другим другими
мембранные: мембранные
момент: момент момента
процесс: процесс процесса
сразу: сразу
простой: простого проще простой
джампер: джампер
закон: законам
помочь: помогло помог помогут
относиться: относятся
состояться: состоится
фиксирована: фиксирована
способствовать: способствовать
включая: включая
удалось: удалось
статья: статьи
полученный: полученный
учитывались: учитывались
пояснение: пояснения
состав: состав составе
великий: великим великие
возможный: возможным возможен возможных возможно
способный: способен способного способна способны
магнитный: магнитного магнитных
впервые: впервые
эволюционировать: эволюционируют
самый: самые самую самых
реган: реган
резонанс: резонанса
выглядеть: выглядят
используются: используются
похожий: похожую похожих
наверняка: наверняка
ионный: ионных
такой: таких
видимый: видимому
старый: старого
укладка: укладка
ренатурации: ренатурации
добавиться: добавились
подоспеть: подоспели
предсказывать: предсказывать
триумф: триумфа
разработка: разработку разработкой
применять: применять применяли
творить: творить
молекула: молекулы молекул молекула молекулам молекулу молекулами
химик: химики
говорить: говорят
делить: делят
начиная: начиная
шаг: шаг
вычислительный: вычислительный вычислительной вычислительном
хьюза: хьюза
расшифровать: расшифровать
морис: морис
долгий: долгое дольше
решена: решена
лауреат: лауреаты лауреатов лауреатом лауреат
обеспечивающих: обеспечивающих
наноматериалах: наноматериалах
команда: командой команда команды
соответствующий: соответствующих
удерживаться: удерживаются
полученная: полученная
дэвид: дэвид
интернет: интернета
седолем: седолем
погружена: погружена
четырех: четырех
слой: слои слоями слоя
остов: остова остовом остов
любопытный: любопытно
выступать: выступают
ряде: ряде
сложность: сложность
дер: дер
эпохальный: эпохальных
обычный: обычных
специфичная: специфичная
неизвестный: неизвестную
круг: кругу
окружающий: окружающей
джону: джону
угол: углов
информация: информацией
повторяться: повторяются
трехмерных: трехмерных
джамперу: джамперу
звено: звеньев
взаимодействовать: взаимодействуют
приближаться: приближается
ассоциативный: ассоциативной
нейросетей: нейросетей
белковый: белков белковые белковых белковой белковый белковом белковая белкового белковыми
противоположный: противоположный
картина: картине
второй: вторая
иероглиф: иероглифы
преодолеть: преодолела
энгельс: энгельс
использованный: использованы
среда: среде
цинковый: цинковый
простимулировал: простимулировал
снизиться: снизилась
основы: основы
петля: петли
понятный: понятно
получать: получали получала
прошел: прошел
различный: различных различные различное
создаваемые: создаваемые
заставить: заставило
имевшими: имевшими
огромный: огромное огромного огромный
университет: университета
обеспечивать: обеспечивают
движение: движении
анфинсена: анфинсена
кендрю: кендрю
связь: связи связями связей
сила: силой силы
одержать: одержала
рибосом: рибосом
количество: количества
характеристика: характеристикам
водородный: водородными водородных водородные
суть: сути
демисом: демисом
болезнь: болезней
орфанных: орфанных
ямр: ямр
удивительный: удивительно
отдельный: отдельных отдельные
привлечь: привлекла
показатель: показатели
попарных: попарных
биология: биологии
четвертичную: четвертичную
точность: точности точность точностью
свой: своим
вторичный: вторичная вторичной
близкий: близкие
синтезированной: синтезированной
дорогой: дорогими
новый: нового новые новых новый
результат: результат результате результатом результаты
перелом: перелом
препарат: препаратов
лежать: лежат
метод: методом
хассабису: хассабису
решить: решил решить
ренатурация: ренатурация
ограничение: ограничений ограничение
пирролизин: пирролизин
химия: химии
рентгеноструктурного: рентгеноструктурного
левинталь: левинталь
позволять: позволяет
последовательность: последовательности последовательность последовательностей
труд: трудами
денатурировать: денатурирует
лиганд: лиганд
позволить: позволила
достаточный: достаточно достаточной
вместе: вместе
высокий: высокой
джампера: джампера
определенном: определенном
рентгеноструктурный: рентгеноструктурный
синтезировать: синтезировали
стероиды: стероиды
конкурент: конкурентов
революция: революцию революции
предшественница: предшественниц
развиваться: развивались
двух: двумя
компания: компании компания
больший: больший большие
полурасплавленного: полурасплавленного
медаль: медали
заряд: заряду
нормальный: нормальную
делать: делать делают
понять: понять
следующий: следующий следующее
современный: современной
ходжкин: ходжкин
моделировать: моделируют
основа: основе основа основой
награда: награды награда
углерод: углерода
катализируют: катализируют
названный: названы названной
полный: полную полного полном полной
приобретение: приобретения
глубокий: глубокого глубоком
третичная: третичная
начало: началом
значимый: значимый
установить: установил установить
цена: ценой
соревнование: соревнование
взаимодействие: взаимодействий взаимодействия
кодирующие: кодирующие
важный: важных важно
противовирусный: противовирусных
экспериментальный: экспериментальным экспериментально экспериментальными
альфа: альфа
матрица: матрицей матрицу
улучшить: улучшить
целевой: целевой
иерархия: иерархия
придавать: придают
живет: живет
относительный: относительно
подробнее: подробнее
пора: порой
обучение: обучения обучении
слева: слева
ядерный: ядерного
третичную: третичную
перевод: перевода
хинтон: хинтон
эффективность: эффективности
несомненный: несомненно
сеть: сетей сети сетях
полинг: полинг
лента: лентах
быстрый: быстро быстрому
собирать: собирали собирает
рост: рост
катализировать: катализировать
сворачивание: сворачивание
клетка: клетке
эвоформере: эвоформере
вроде: вроде
первый: первым первую первом первые первыми первых
вакцина: вакцин вакцины
ждет: ждет
хассабис: хассабис
принятый: принятые
лавинообразно: лавинообразно
качественно: качественно
газ: газа
избирательный: избирательно
база: базы
взбивать: взбиваем
замысел: замыслом
оценка: оценки оценка
вручение: вручение
называть: называют
превращать: превращают
разнообразный: разнообразных
комплекс: комплекса комплексов
парадокс: парадокса
ван: ван
рубеж: рубеже
эвоформер: эвоформер
трехмерную: трехмерную
получившим: получившим
велик: велика
который: которыми которую
особенность: особенностях
связаны: связаны
приобретет: приобретет
демису: демису
впечатляющий: впечатляющий впечатляющих впечатляющие
работать: работают работает работали
язык: языка язык
показано: показано
одно: одно
рекордный: рекордными
биофизик: биофизики
ренатурируют: ренатурируют
проходить: проходит
пикомолярной: пикомолярной
свыше: свыше
десятилетие: десятилетий
эволюция: эволюции
криоэлектронная: криоэлектронная
область: областях области
английски: английски
существ: существ
добавить: добавить
программа: программа программы программе программ программу
фолдинг: фолдинг
ход: ходе
полипептидная: полипептидная
сбываться: сбываются
гидрофобная: гидрофобная
структура: структуры структурой структуру структура структуре структур
сложный: сложную сложно сложным
перуцу: перуцу
томасом: томасом
селеноцистеин: селеноцистеин
рисунок: рисунки рисунок
состоять: состоял
созданной: созданной
прежде: прежде
руководствоваться: руководствовались
указывать: указывает
характерный: характерна характерную
становиться: становится
ландшафт: ландшафте
мембрана: мембранах
устанавливать: устанавливать
исключительный: исключительное исключительно
конкурс: конкурс конкурсе
отдельность: отдельности
премия: премии премия премию премией
детище: детище детища
превратив: превратив
итак: итак
моделирование: моделирование
лайнус: лайнус
значимость: значимость
закономерность: закономерностях
борисович: борисович
предполагаемый: предполагаемой
спустя: спустя
приобретать: приобретает
энергетический: энергетическом
проблема: проблему
ковалентных: ковалентных
значение: значение значением
инструмент: инструмента
смысл: смысле
соответствовать: соответствовала
набор: набором
медицина: медицине
одну: одну
вашингтонского: вашингтонского
состояние: состояния
нарастать: нарастало
неделя: неделя
число: числе число числа
бета: бета
организоваться: организуется
опорный: опорные
секвенирования: секвенирования
слово: слова
направо: направо
закодированной: закодированной
решение: решение решения
палец: палец
моль: моль
открытие: открытий открытию
половина: половина
создавшие: создавшие
путь: пути
физик: физиков
фредерик: фредерик
применить: применили
занимающейся: занимающейся
форма: форме форму формы
ротор: роторы
орёл: орлов
например: например
награждённый: награждена
цинк: цинка
век: века веков
мономеров: мономеров
вопрос: вопрос вопросов
грядущий: грядущей
объективность: объективностью
точный: точное точно
дальний: далее
уступать: уступает уступали
разрешение: разрешение
требующую: требующую
произвести: произвели
джеймс: джеймс
многократный: многократно
установление: установления
венкатраман: венкатраман
частность: частности
достигнуть: достигли
размер: размеру размером
отмечен: отмечен
искусственный: искусственного искусственным искусственные искусственному
узнать: узнал
синтезированы: синтезированы
нейронный: нейронных нейронные
отличаться: отличаются отличается
комитет: комитетом
цвет: цветами
дэвида: дэвида
гораздо: гораздо
нобелевский: нобелевской нобелевскую нобелевская нобелевские нобелевским
фибриллярные: фибриллярные
антуан: антуан
самопроизвольный: самопроизвольно
идентичный: идентичны
ныне: ныне
координаты: координаты
нужный: нужной нужную нужные нужных
самостоятельный: самостоятельного самостоятельный
превышать: превышает
розеттского: розеттского
ранжированных: ранжированных
скорый: скоро
коллега: коллегами коллеги коллег
первичный: первичной первичную первичная
правильный: правильного
существовать: существует существовал
играть: играют
май: мае
выдающийся: выдающейся выдающийся
большинство: большинство
йонат: йонат
пар: парами
счет: счет
использовать: использовала используют использовали
сенгер: сенгер
кислота: кислот
любой: любому любых
подтвердить: подтвердили
аминокислотный: аминокислотной аминокислотных аминокислотная аминокислотные аминокислотного аминокислотными
повторяющихся: повторяющихся
узнающих: узнающих
выравнивание: выравнивании выравнивания
кристаллография: кристаллография
использовались: использовались
мостик: мостики
поиск: поиск поиска
деятельность: деятельности
основанный: основанную основанные основана
потребовать: потребовало
выяснить: выяснить
стоимость: стоимость
удостоены: удостоены
достаться: достанется
чередование: чередования
сформулировал: сформулировал
опасный: опасные
научиться: научились
вещество: вещества
кристиан: кристиан
кристалл: кристаллы
блочный: блочная
глава: главе
инвариантный: инвариантной
многие: многих многие
дизайнерских: дизайнерских
победа: победы
карло: карло
оптимизация: оптимизации
разработанная: разработанная
сенсоров: сенсоров
критический: критическая
ученых: ученых
служить: служат
запланированная: запланированная
превзойти: превзойти
получившаяся: получившаяся
адой: адой
основный: основным
фуркруа: фуркруа
стать: стали стало станет
настоящий: настоящий настоящую
дорогостоящий: дорогостоящим
имя: имена именем
сформулирована: сформулирована
способ: способ способы
годиться: годится
платформа: платформ
полипептидов: полипептидов
происходить: происходит
вращение: вращение
роль: роль роли
организм: организме организм
опираться: опираться
блок: блоков блоки блоками блоках блок
перутца: перутца
вероятный: вероятно
четверть: четверти
прорыв: прорыв прорыва
теория: теории
микроскопия: микроскопия
вызов: вызовом
дифракция: дифракции
среди: среди
наука: науки науке
упираться: упиралось
полимер: полимеры
высший: высшей высшая
неразрывный: неразрывно
ровный: ровно
олег: олег
множество: множество
сайт: сайтов сайта
знать: знали знаем знает
отметить: отметить
годы: годы
существующий: существующих
точнее: точнее
нарушение: нарушения
ваальса: ваальса
перебор: перебора
сворачиваться: сворачиваются
появление: появлением
паттернов: паттернов
устойчивый: устойчивые
связывающих: связывающих
дисульфидные: дисульфидные
случиться: случился
сообщить: сообщил
ждать: ждать
бейкер: бейкер
яичный: яичный
созданы: созданы
оценить: оценить
крупный: крупные крупную крупной
обновляться: обновляется
определена: определена
растворитель: растворителя
коллектив: коллектив коллективов
атом: атомов атомами
биохимия: биохимии
взаиморасположением: взаиморасположением
входить: входить
исходный: исходно исходным
схема: схема
генетический: генетических
ученые: ученые
ним: ним
игра: играх
технология: технологии
оффлайн: оффлайн
либо: либо
частица: частиц
заря: заре
работа: работы работу работа
прочтение: прочтения
система: система
фридрих: фридрих
денатурация: денатурация
крик: крика крик
крайний: крайней
наступить: наступил
джон: джон
химический: химическая химические химическими
вверху: вверху
конец: конце
помощь: помощью помощи
структурный: структурной структурном структурный
усилие: усилий
уотсон: уотсон
волокно: волокна
понимание: понимание
образовать: образуют
боковые: боковые
одним: одним
дизайнерские: дизайнерские
класс: класса
мотив: мотивом
менять: меняют
нуклеотид: нуклеотидов
стоять: стоит
уильям: уильям
организатор: организаторов
сверточных: сверточных
полученные: полученные
физика: физике физики
расположенный: расположенные
ничтожный: ничтожные
объемы: объемы
техник: техники
сто: сто
настолько: настолько
будущий: будущем
концентрация: концентрации
соответствие: соответствие
несмотря: несмотря
расстояние: расстояния расстояний
вид: виде видов
экспрессия: экспрессию
успешный: успешно успешного успешнее успешны
рнк: рнк
ускорять: ускорять ускоряют
трехмерным: трехмерным
предпосылка: предпосылки
похвастаться: похвастаться
обратимый: обратима
организация: организации
гидрофобных: гидрофобных
оценивать: оценивают
общество: общества
последний: последние
округлый: округлую
человек: человека
декабрь: декабря
сайрус: сайрус
путем: путем
деградо: деградо
сравнимый: сравнима
сияние: сиянии
иметь: имеют имеет
годов: годов
образованный: образованный
возвращать: возвращает
воронко: воронку
