малый: малый
условие: условиях
зеленой: зеленой
сацума: сацума
сера: серы
хлор: хлор
обычный: обычной
вулканический: вулканического
очередь: очередь
доказательство: доказательства
считать: считать считает
включенным: включенным
часы: часы
тандем: тандеме
видимый: видимого
похвастаться: похвастаться
интерпретировать: интерпретировать
растительность: растительностью
катастрофа: катастрофа катастрофой катастрофы
свидетель: свидетели
последовательность: последовательностей
стать: стали стало
например: например
ресурс: ресурс
вид: виде вид
рубеж: рубеже
рэлеевскому: рэлеевскому
организм: организмов
цианобактерии: цианобактерии
окислять: окислять окисляет
биосфера: биосферы
растворенное: растворенное
коллоидный: коллоидный коллоидного коллоидным
солнечный: солнечный
мнение: мнению
эффект: эффекта
почвенный: почвенных
сочетание: сочетании
кварцит: кварцитов
ранее: ранее
двухвалентного: двухвалентного
освещаться: освещались
кислородный: кислородная кислородного кислородной
бледный: бледно
снежок: снежок
насыщенный: насыщен
сверху: сверху
должный: должен
гидроксидом: гидроксидом
окислительный: окислительной
залиться: залейся
япония: япония
оценка: оценки
выделяемых: выделяемых
выброс: выбросами
поглощаться: поглощаются
неоднозначный: неоднозначные
эволюция: эволюции эволюцию
фото: фото
исследователь: исследователи
услышав: услышав
имеющий: имеющий
происхождение: происхождения
зеленые: зеленые
дыхательный: дыхательной
очевидный: очевидное
узкий: узкий узком
белковый: белковых
вызвавшей: вызвавшей
газ: газа
означать: означает
фикоэритрина: фикоэритрина
версия: версии
свет: свет света светом свете свету
оттенок: оттенки
оксидативного: оксидативного
фотосинтеза: фотосинтеза
составлять: составляла
пропускать: пропускает пропускал
рост: рост
привыкнуть: привыкли
процесс: процесса процесс
автор: автора авторы авторов
справедливость: справедливости
представляться: представляется
давным: давным
рассеяние: рассеянию рассеяния
мочь: могли
выдвинуть: выдвинуть
сайт: сайта
смысл: смысле
развившись: развившись
указывать: указывают указывает
учёный: учёным
ради: ради
мир: мир
древние: древних
наполняться: наполнялась
приобрести: приобрели
возникнуть: возникли возник
серный: серный
горячий: горячих
морской: морском морские морская
зеленить: зелени
появление: появления появлении
обладатель: обладателям
картина: картину
гипотеза: гипотезу гипотезе гипотеза
млрд: млрд
неисчерпаемый: неисчерпаемый
известный: известны известного
обсуждаемой: обсуждаемой
польза: пользу
тысяча: тысячу
утилизировать: утилизировать
обитать: обитают
развиваться: развивались
ген: гены генов
наблюдательный: наблюдательным
середина: середина
настолько: настолько
зеленоватый: зеленовато
поодиночке: поодиночке
измерить: измерили
математический: математически математическую математическими
перенастроенные: перенастроенные
поглощение: поглощение поглощения
окрашены: окрашены
нептун: нептун
небо: небо
формируя: формируя
решение: решения
сохраниться: сохранилась
минь: минь
большой: большого
эоне: эоне
установить: установили
высокий: высоким выше
распространение: распространение
зеленый: зеленый
наличие: наличие
георгий: георгий
обязанный: обязаны
сильнейший: сильнейшего
энергия: энергии
горный: горных
порядок: порядка
фикоэритрин: фикоэритрин
покрытый: покрытые
тогдашний: тогдашних
скучный: скучные
восстановительный: восстановительной
предполагать: предполагают
одно: одно
диапазон: диапазон
живших: живших
убеждённый: убеждена
примерно: примерно
континент: континентов континенты континентах
уступающего: уступающего
оказаться: оказалось
соединение: соединений
помочь: помог
совершенный: совершенно
отражаться: отражаются
сила: силе
отражение: отражения
иллюстрация: иллюстрация
система: систем
цианобактерий: цианобактерий
растение: растений
данные: данными
архея: архея
комплекс: комплексы комплекса
преимущественный: преимущественно
фотосистем: фотосистем
постулировать: постулируют
сотворить: сотворили
горизонтальный: горизонтального горизонтальный
ранний: ранних
рассказывалось: рассказывалось
световом: световом
свидетельствовать: свидетельствуют
снятый: снято
повлиять: повлияла
район: районе
новость: новости
отметить: отметим
отмечать: отмечает
вода: воду воды воде водой вода
среда: среда среде
размер: размер
резкий: резко
интригующий: интригующая
химически: химически
долгий: долгое
демонстрировать: демонстрирует
сам: самое
получаться: получается
построить: построили
проливать: проливает
никакой: никакой никаких
эволюционировать: эволюционировали
путать: путать
частить: части
точка: точкой точке
ученые: ученые
профессор: профессор
явный: явно
планета: планету
приобретать: приобретать
абсолютный: абсолютно
идет: идет
пример: пример
спровоцированный: спровоцированный
последствие: последствие
меньшой: меньшую
геном: геномы
зелёный: зелёного
путем: путем
окислиться: окислиться
динамика: динамика
широкий: широкое
массово: массово
сразу: сразу
остров: острова остров
акватория: акватория
нужный: нужны
рис: рис
архейском: архейском
светопропускание: светопропускание
основный: основном
сфотографировать: сфотографировали
экосистема: экосистемы
менять: меняют
глубина: глубины глубину
другой: другого
работая: работая
длина: длины длиной длин
связь: связи
километр: километров
бактерия: бактерий бактериям
прийтись: пришлось
архипелаг: архипелаге
чувствительный: чувствительные
светопоглощения: светопоглощения
берег: берега
пигмент: пигмент пигментов пигменты
железистый: железистых
эксперимент: экспериментах
содержание: содержанием
новый: новый
элемент: элементы
токсичный: токсичен
снаружи: снаружи
миллиард: миллиардов
экспериментальный: экспериментально
съемка: съемка
перенос: переноса перенос
революция: революция
проверить: проверить
фикоэритринов: фикоэритринов
цианобактериями: цианобактериями
химический: химический химическими
группа: группа
трех: трех
количество: количества
опубликованные: опубликованные
тезки: тезки
источник: источников источник
сказано: сказано
заполучить: заполучила
двухвалентное: двухвалентное
предстает: предстает
белка: белки
порода: пород
форма: формы
дифференциальных: дифференциальных
университет: университете
двухвалентным: двухвалентным
некоторый: некоторое
филогенетический: филогенетический
осторожный: осторожно
своем: своем
возможный: возможно
протерозоя: протерозоя
иметь: имели имеют имеет
отложившись: отложившись
модель: модель
численный: численного
внутри: внутри
свободный: свободного
используя: используя
вулкан: вулканами
монохромный: монохромный
светособирающие: светособирающие
приобрел: приобрел
статья: статьи статье
состав: состав составе
поздний: позднем
зеленому: зеленому
комбинация: комбинацией
показать: показали показал
современный: современной современных
защита: защиты
срочный: срочно
позволять: позволяет
косвенный: косвенные
жить: жили
плохой: хуже
попытаться: попытались
какой: какое какие какого
буквальный: буквальном буквально
сложнее: сложнее
помощь: помощью
окисляться: окислялись
синеватый: синевато
образование: образованием образования
уравнение: уравнений
минимальный: минимальное
комментарий: комментарии
соседствовать: соседствовали
практически: практически
впоследствии: впоследствии
зеленого: зеленого
согласный: согласно
тон: тонах
сагана: сагана
окисление: окисления
спектр: спектра
интересный: интересное
узнать: узнаем
расстояние: расстояния
придавать: придают
подводный: подводный подводная
насчитать: насчитали
рэлеевского: рэлеевского
стресс: стресса
основа: основе
наночастицы: наночастицы
удалось: удалось
видеть: видели
помогающего: помогающего
окно: окне
океан: океанами океанов океаны океанах океане океан океана океаном
приспособленных: приспособленных
разный: разных разному
насыщение: насыщения насыщении
выражение: выражению
наночастиц: наночастиц
раствор: раствор
входить: входят
смоделировать: смоделировать
генный: генных
проникать: проникал проникает
ученых: ученых
полосчатых: полосчатых
однозначный: однозначной
архейского: архейского
японский: японские японским
улавливающий: улавливающий
вспомнить: вспомним
оседать: оседать
улавливать: улавливать
встречаемость: встречаемость
белый: белом
биология: биологии
атмосфера: атмосфере атмосфера
железо: железа железом железо
голубой: голубую голубыми голубых голубом
весь: всей
несмотря: несмотря
призвать: призвали
эона: эона
богатый: богаты
волна: волн волны
провести: провели
гораздо: гораздо
исходный: исходной
дно: дне
возле: возле
окраска: окраска
самый: самым
цепь: цепи
голуба: голубой
точный: точное
слой: слое
сталкивающихся: сталкивающихся
конец: конце
синий: синему синюю синий синими сине
использовать: использовали
фтору: фтору
такой: таком таким таких такого
отсутствовать: отсутствовал
метод: методом
мкмоль: мкмоль
светособирающего: светособирающего
цвет: цвета цвету цвет
смочь: смогли
максимум: максимум
земля: земля земли землю земле
расположение: расположения
свой: своим
гидроксида: гидроксида
зеленая: зеленая
выглядеть: выглядела выглядеть
концентрация: концентрации концентрация концентрацию
иводзимой: иводзимой
сегодняшний: сегодняшний
поэтому: поэтому
цианобактериям: цианобактериям
анализ: анализ
выкладка: выкладки
перестройка: перестройку
превосходящего: превосходящего
получение: получением
наилучший: наилучшее
создается: создается
меткий: меткому
сохранявшимся: сохранявшимся
время: времена
зелеными: зелеными
повысилась: повысилась
окислилось: окислилось
море: море
приповерхностном: приповерхностном
лежать: лежит
новооткрытых: новооткрытых
оценить: оценить
зеленым: зеленым
древний: древняя древней древнего древний
общий: общем
трехвалентное: трехвалентное
иодзима: иодзима
кислород: кислорода кислород кислородом
говорить: говорить
свидетельство: свидетельства
составляющая: составляющих
чэнь: чэнь
сидней: сиднея
филогенетика: филогенетика
журнал: журнале журналу
куракин: куракин
постепенный: постепенно
существовать: существуют
карла: карла
молекулярный: молекулярные молекулярной
подарив: подарив
название: название
подробный: подробно
