зверь: звере
например: например
иметь: имела
новый: новые новая
возникнуть: возникло
углерод: углероду
сохранившейся: сохранившейся
мамонтовой: мамонтовой
вид: вида вид
частить: части
отличаться: отличался отличаются отличалось
строение: строения строение строении
стадия: стадии
особенность: особенностей
глубокий: глубокой
якутский: якутская якутский
номер: номер
развитие: развития
юг: юге
плохой: хуже
сайт: сайта
сильный: сильнее
оценить: оценили
установленный: установлено
характерный: характерную характерные
сохранность: сохранности
самый: самых
успешный: успешных
прыгать: прыгали
земля: земле
дно: дна
реконструкция: реконструкции
мягкий: мягких мягкая
узнать: узнать
ранний: ранней ранние
время: времена
насколько: насколько
тушить: туши
годы: годы
холка: холке
мех: мех
грудной: грудного
пространство: пространств
медленный: медленнее
мощный: мощная
фланец: фланец
представитель: представителю
твердой: твердой
крепкий: крепко
сулить: сулят
придавать: придавало
скелетные: скелетные
регион: регионе
служить: служит
животное: животных животного
гепард: гепарда
лёд: льда
трехнедельного: трехнедельного
миллиметр: миллиметра
проявившейся: проявившейся
помимо: помимо
обращать: обращают
современный: современным современных современные современного
котенок: котенок
низкий: низкого
резец: резцов резцы
трехнедельный: трехнедельный
средний: среднего
исключение: исключением
оказаться: оказались оказался оказалась
мелкий: мельче
подушечка: подушечки подушечка
вроде: вроде
существование: существования
тазовый: тазовые
анатомия: анатомию анатомии анатомией
нежный: нежном
посткраниальной: посткраниальной
сдвиг: сдвиги
сделана: сделана
река: реки
премоляры: премоляры
одними: одними
лапа: лапы лапа
спустя: спустя
компьютерный: компьютерная компьютерной
килограммовый: килограммов
находить: находили
львенка: львенка
увеличенные: увеличенные
второй: вторых второго
чей: чей
знаменитый: знаменитые знаменитого
обозначение: обозначение обозначения
область: области
возможность: возможность
больший: большую большей
жизнь: жизни
аргумент: аргументом
приток: притока
новосибирск: новосибирском
трех: трех
галоп: галопом
сделанная: сделанная
высота: высотой
свет: свет
столкнуться: столкнуться
гораздо: гораздо
детенышей: детенышей
африканский: африканских
предчелюстные: предчелюстные
польза: пользу
выглядеть: выглядели
сантиметр: сантиметров
позвонок: позвонка
единственный: единственным
адаптация: адаптации
превосходить: превосходит
показать: показало
крупный: крупнее крупных крупные крупными
кошачьи: кошачьих кошачьими
америка: америки
шерсть: шерсти шерсть
ледниковый: ледникового
маленький: маленький
республика: республики
результат: результаты
котенка: котенка
образ: образ
предположив: предположив
мясо: мясо
гипертрофированные: гипертрофированные
генетический: генетически
справа: справа
стать: стало
сочлененные: сочлененные
настоящий: настоящие
опираясь: опираясь
примечательный: примечательная примечательна
начинать: начинали начинают
кошка: кошки кошек кошкам
палеонтолог: палеонтологам
столь: столь
состав: составе
голый: голые
отросток: отростка отросток
бадярихской: бадярихской
черта: черта черты
усы: усы
смилодона: смилодона
вдвое: вдвое
позволять: позволяют позволяло
конец: конце концов
ушко: ушки
тигровый: тигров
внимание: внимание
кусок: куске
округлый: округлая
гомотериев: гомотериев
техас: техаса
вымереть: вымерли
фланца: фланца
спина: спина спине
котёнок: котят
мозговая: мозговая
расширить: расширить
отдел: отделе
изменение: изменения
расселяющимися: расселяющимися
коллекция: коллекции
североамериканскому: североамериканскому
африка: африке
способствовать: способствует
источник: источник
имеющийся: имеющиеся
длинный: длинными длинные длиннее длинная
относительный: относительно
нанести: нанести
имея: имея
неделя: недель
снег: снегу
вонзать: вонзать
якутия: якутии якутия
львенком: львенком
вымерший: вымершего
смертельный: смертельный
долгий: дольше долгое
улус: улусе
изучить: изучить
северный: северной северных северного
минимум: минимум
течение: течение
прочее: прочего
древнейший: древнейшие
копытный: копытных
индигирки: индигирки
передний: переднюю передние передней передняя
уха: уха
намного: намного
благодаря: благодаря
бадяриха: бадяриха
назвать: назвали
просматриваемые: просматриваемые
жила: жил
ранее: ранее
гомотерии: гомотерии
распространенных: распространенных
жесткая: жесткая
вероятный: вероятно
легким: легким
детеныша: детеныша
идентичный: идентичен
якутске: якутске
лапка: лапке
рисунок: рисунок
уступать: уступали
короткий: короткая короткого короче
принадлежность: принадлежность принадлежностью
тело: тело тела
обломаны: обломаны
полувтяжными: полувтяжными
коготь: когтями коготь
прорисовка: прорисовка
использование: использованием
положение: положения
бассейн: бассейне
провести: провели
нескольких: нескольких
яркий: яркая ярких
такой: таких
млн: млн
конкуренция: конкуренцию
ширина: ширина
четко: четко
заметный: заметно
сохраниться: сохранились
холодный: холодному холодной
продержаться: продержались
фауна: фаун фауны
сохранившийся: сохранившийся
появление: появления
считать: считать
окаменелость: окаменелостей
находка: находки находка
период: периода
скелетная: скелетная
храниться: хранится
возраст: возрасте возрастом возраст возраста
львёнок: львят львята
запад: запад
большинство: большинство
известный: известных
приспособление: приспособлением
массивный: массивные
ускоряться: ускорялись
различный: различные различного
неоднократный: неоднократно
проблема: проблем
часть: часть частью
компактный: компактные
переслать: перешли
погибнуть: погиб
мочь: могли
ряд: ряда
определение: определением
сохранившуюся: сохранившуюся
удар: удар
проявляться: проявлялись
уникальный: уникальной уникальную уникальная
молочный: молочных
губа: губе
единый: едином
метр: метра
преследуя: преследуя
высказываться: высказываются
симфиза: симфиза
погибший: погибшего
месяц: месяца
облик: облик
гипотеза: гипотезы
сравнение: сравнение
евразия: евразии евразию
тёмный: темно
коричневый: коричневая
вчетверо: вчетверо
палец: пальца
евразийский: евразийских
море: моря
расселиться: расселились
экспансия: экспансия
зуб: зубов
видовой: видовой
примерно: примерно
исключено: исключено
глаз: глазами
хищник: хищники хищниками
нога: ноги ногах
заподозрить: заподозрить
скелет: скелета
американский: американские
человек: людьми
отличие: отличие
слева: слева
прорезавшиеся: прорезавшиеся
выносливость: выносливостью
московский: московского
тепло: тепла
массивнее: массивнее
выйти: вышла
вымирание: вымирания
носовой: носовые
берингов: берингов
открытие: открытия
найти: нашли
снизу: снизу
автор: авторы
изучение: изучения изучение
уменьшение: уменьшению
большой: большого
европа: европы
выловленная: выловленная
повторно: повторно
гомотерия: гомотерия
уточнить: уточнить
молодой: молодые молодых моложе
многие: многие
причина: причин
мордочка: мордочки
саха: саха
исследователь: исследователи
пасть: пасти пасть
реконструировать: реконструировать
территория: территории
охотившимися: охотившимися
жертва: жертв жертву
колумбийские: колумбийские
мамонт: мамонты
правый: правого правой
составить: составил
пещерный: пещерных пещерный
картинка: картинку
дуга: дугу
перешеек: перешеек
значительный: значительно
выраженного: выраженного
принадлежащий: принадлежащая
шея: шее шея
образец: образца образец
найдены: найдены
подтверждаться: подтверждается
сравнительный: сравнительно сравнительный
гиена: гиены
отсутствовать: отсутствует
трехнедельном: трехнедельном
род: роду
добраться: добрались
распространившись: распространившись
добыча: добычу
формирующие: формирующие
остаток: остатки остаткам остатков
схожесть: схожесть
основа: основе
материал: материалов
беречь: берегу
взрослый: взрослые взрослого
лучший: лучшей
томографии: томографии
понять: понять
внешний: внешние внешнего внешний внешних
обсуждаемой: обсуждаемой
установить: установить установили
потеря: потерь
плейстоцен: плейстоцена
вдобавок: вдобавок
коробок: коробка
полярный: полярных
прорезывание: прорезывания
место: место
будучи: будучи
скорый: скорее
нижнечелюстного: нижнечелюстного
приподнятый: приподнятого
верхний: верхние верхней
походка: походке походкой
подсемейство: подсемейства
длина: длина длину
томография: томография
размер: размерами
музей: музея
толстый: толще
венесуэлы: венесуэлы
левый: лев
грудь: груди
несомненный: несомненно
покров: покровы покровов
климат: климата климату
представление: представления
сопротивляющийся: сопротивляющуюся
высказано: высказано
достигать: достигали
полностью: полностью
густой: густая
пересматривался: пересматривался
смертоносный: смертоносными
вместе: вместе
университет: университете университета
выпуклый: выпуклую
мускулистее: мускулистее
гомотерий: гомотерий
бадьяриха: бадьяриха
неполный: неполные
бедренный: бедренной
уголок: уголках
континент: континентов
первый: первая первых
статья: статьи статья
весить: весили
щечных: щечных
трехнедельных: трехнедельных
ткань: тканей
специализированными: специализированными
нижний: нижней
зоологический: зоологического
передвигаться: передвигаться
встречаться: встречались
череп: черепов черепа
миллиметровый: миллиметров
исчезнувших: исчезнувших
поскольку: поскольку
мякиш: мякиши
равный: равны
мумия: мумия мумий мумии мумией
журнал: журнале
клык: клыки клыками
обладать: обладали
европейский: европейский
широкий: широко шире широкая
лев: львам льва львов
костя: кости
питаться: питаться
найденным: найденным
предположение: предположение предположения
передвижение: передвижению
удерживать: удерживать
позволить: позволила
венечный: венечного венечный
государственный: государственном государственного
общий: общий
предоставить: предоставила
миллион: миллиона
последний: последний последние
анна: анна
отношение: отношении
кость: костями
смочь: смогли
восточный: восточной
каталог: каталоге
нижнечелюстной: нижнечелюстной
челюсть: челюсти челюсть
день: дня
датировка: датировку
новиковская: новиковская
описание: описанием
замечательный: замечательной замечательные
вибриссы: вибриссы
пища: пищей
фотография: фотография
родственник: родственников
большеберцовой: большеберцовой
саблезубый: саблезубые саблезубой саблезубый саблезубых саблезубым
детеныш: детеныш
судя: судя
необычный: необычном
основание: основании
мускулистый: мускулистые
несущий: несущие
малыш: малыши малышей
обратить: обратите
прозванный: прозванный
анализ: анализ
покрывать: покрывает
голова: головы голова
запястная: запястная
открытый: открытых
скелетных: скелетных
абыйском: абыйском
условный: условные
связанный: связанные
львиный: львиного
повторный: повторная
